çıçek	çıçek
çığ	çığ
çığır	çığır
çığlı	çığlı
çığlığı	çığlığ
çığlığını	çığlığ
çığlığa	çığlığ
çığlık	çığlık
çığlıklar	çığlık
çığlıkları	çığlık
çığlıklarını	çığlık
çığrından	çığrı
çık	çık
çıkığı	çıkığ
çıkış	çıkış
çıkışı	çıkış
çıkışımızı	çıkış
çıkışın	çıkış
çıkışını	çıkış
çıkışının	çıkış
çıkışına	çıkış
çıkışında	çıkış
çıkışındaki	çıkış
çıkışından	çıkış
çıkışıyla	çıkış
çıkışa	çıkış
çıkışlı	çıkış
çıkışla	çıkış
çıkışlar	çıkış
çıkışları	çıkış
çıkışların	çıkış
çıkışlarını	çıkış
çıkışlarının	çıkış
çıkışlarına	çıkış
çıkışlarında	çıkış
çıkışlarından	çıkış
çıkışlarda	çıkış
çıkışta	çıkış
çıkıştan	çıkış
çıkık	çıkık
çıkıkların	çıkık
çıkılır	çık
çıkılırsa	çık
çıkılıyor	çıkıl
çıkılabilir	çık
çıkılabilmektedir	çık
çıkılacak	çık
çıkılamayacak	çıkıla
çıkılamaz	çıkıla
çıkılan	çık
çıkılarak	çık
çıkıldı	çık
çıkıldığı	çık
çıkıldığında	çık
çıkıldıkça	çık
çıkıldıktan	çık
çıkılmıştır	çık
çıkılmalıdır	çık
çıkılması	çık
çıkılmasına	çık
çıkılmaz	çık
çıkın	çık
çıkınız	çık
çıkınca	çık
çıkıncaya	çık
çıkıntı	çıkıntı
çıkıntılı	çıkıntı
çıkıntılar	çıkıntı
çıkıntıları	çıkıntı
çıkıntıların	çıkıntı
çıkıp	çık
çıkıyor	çık
çıkıyordu	çık
çıkıyorlar	çık
çıkıyorlardı	çık
çıkıyormuş	çık
çıkıyorsa	çık
çıkıyorsunuz	çık
çıkıyorum	çık
çıkıyoruz	çık
çıka	çık
çıkabildiği	çık
çıkabileceği	çık
çıkabileceğini	çık
çıkabilecek	çık
çıkabilecektir	çık
çıkabilen	çık
çıkabilir	çık
çıkabilirdi	çık
çıkabiliriz	çık
çıkabilirler	çık
çıkabilirsiniz	çık
çıkabiliyor	çık
çıkabilme	çık
çıkabilmek	çık
çıkabilmektedir	çık
çıkabilmesi	çık
çıkabilmiştir	çık
çıkacağı	çıkacağ
çıkacağım	çık
çıkacağını	çıkacağ
çıkacağınıza	çıkacağ
çıkacağına	çıkacağ
çıkacağından	çıkacağ
çıkacağız	çık
çıkacak	çık
çıkacaklar	çık
çıkacaklarını	çıkacak
çıkacaklardır	çık
çıkacaksınız	çık
çıkacaktı	çık
çıkacaktır	çık
çıkalım	çık
çıkamıyor	çık
çıkamadı	çık
çıkamadım	çık
çıkamamış	çık
çıkamayacağını	çık
çıkamayan	çık
çıkamaz	çık
çıkamazlar	çık
çıkan	çık
çıkana	çık
çıkanlar	çık
çıkanları	çık
çıkanların	çık
çıkanlara	çık
çıkanlardan	çık
çıkar	çık
çıkarı	çıkar
çıkarıcı	çıkar
çıkarılıncaya	çıkar
çıkarılıp	çıkar
çıkarılır	çıkar
çıkarılırken	çıkar
çıkarılırlar	çıkar
çıkarılırsa	çıkar
çıkarılıyor	çıkar
çıkarılabileceğini	çıkar
çıkarılabilecek	çıkar
çıkarılabilir	çıkar
çıkarılabilmektedir	çıkar
çıkarılabilmesi	çıkar
çıkarılacağı	çıkar
çıkarılacak	çıkar
çıkarılacaktır	çıkar
çıkarılamaz	çıkar
çıkarılan	çıkar
çıkarılanlar	çıkar
çıkarılanların	çıkar
çıkarılarak	çıkar
çıkarıldı	çıkar
çıkarıldığı	çıkar
çıkarıldığını	çıkar
çıkarıldığında	çıkar
çıkarıldıkları	çıkar
çıkarıldıktan	çıkar
çıkarılmış	çıkar
çıkarılmıştı	çıkar
çıkarılmıştır	çıkar
çıkarılma	çıkar
çıkarılmadan	çıkar
çıkarılmak	çıkar
çıkarılmakta	çıkar
çıkarılmaktadır	çıkar
çıkarılmalı	çıkar
çıkarılmalıdır	çıkar
çıkarılmaları	çıkar
çıkarılmamış	çıkar
çıkarılmamalıdır	çıkar
çıkarılmaması	çıkar
çıkarılması	çıkar
çıkarılmasıdır	çıkar
çıkarılmasını	çıkar
çıkarılmasının	çıkar
çıkarılmasına	çıkar
çıkarılmasında	çıkar
çıkarılmasından	çıkar
çıkarılmasıyla	çıkar
çıkarılmaya	çıkar
çıkarılmaz	çıkar
çıkarım	çık
çıkarımı	çıkar
çıkarın	çıkar
çıkarını	çıkar
çıkarınız	çıkar
çıkarına	çıkar
çıkarıp	çıkar
çıkarır	çıkar
çıkarırım	çıkar
çıkarırdı	çıkar
çıkarırken	çıkar
çıkarırlar	çıkar
çıkarırsınız	çıkar
çıkarırsa	çıkar
çıkarıyor	çıkar
çıkarıyordu	çıkar
çıkarıyorlar	çıkar
çıkarıyorsa	çıkar
çıkarıyorsunuz	çıkar
çıkarıyorum	çıkar
çıkarıyoruz	çıkar
çıkarız	çık
çıkara	çıkar
çıkarabileceği	çıkar
çıkarabilecek	çıkar
çıkarabilir	çıkar
çıkarabiliriz	çıkar
çıkarabilirler	çıkar
çıkarabilirsiniz	çıkar
çıkarabiliyor	çıkar
çıkarabilmek	çıkar
çıkaracağı	çıkar
çıkaracağını	çıkar
çıkaracağız	çıkar
çıkaracak	çıkar
çıkaracakları	çıkar
çıkaracaksınız	çıkar
çıkaracaktır	çıkar
çıkarak	çık
çıkaralım	çıkar
çıkaramadım	çıkar
çıkaramaz	çıkar
çıkaran	çıkar
çıkaranlar	çıkar
çıkaranları	çıkar
çıkararak	çıkar
çıkarcı	çıkarcı
çıkardı	çıkar
çıkardığı	çıkar
çıkardığım	çıkar
çıkardığımız	çıkar
çıkardığını	çıkar
çıkardığınız	çıkar
çıkardığınızda	çıkar
çıkardık	çıkar
çıkardıkları	çıkar
çıkardıklarını	çıkar
çıkardıktan	çıkar
çıkardılar	çıkar
çıkardım	çıkar
çıkardınız	çıkar
çıkarken	çık
çıkarlar	çık
çıkarları	çıkar
çıkarlarımız	çıkar
çıkarlarımızı	çıkar
çıkarlarımıza	çıkar
çıkarların	çıkar
çıkarlarını	çıkar
çıkarlarının	çıkar
çıkarlarına	çıkar
çıkarlarından	çıkar
çıkarlarıyla	çıkar
çıkarlara	çıkar
çıkarmış	çıkar
çıkarmışlardı	çıkar
çıkarmıştı	çıkar
çıkarmıştır	çıkar
çıkarmıyor	çıkar
çıkarma	çıkar
çıkarmadı	çıkar
çıkarmada	çıkarma
çıkarmadan	çıkar
çıkarmak	çıkar
çıkarmakla	çıkar
çıkarmaktı	çıkar
çıkarmaktır	çıkar
çıkarmakta	çıkar
çıkarmaktadır	çıkar
çıkarmaktadırlar	çıkar
çıkarmalı	çıkar
çıkarmalar	çıkarma
çıkarmaları	çıkarma
çıkarmaların	çıkarma
çıkarmamız	çıkarma
çıkarmamak	çıkar
çıkarmaması	çıkar
çıkarmamaya	çıkar
çıkarmanın	çıkarma
çıkarmanız	çıkarma
çıkarması	çıkarma
çıkarmasını	çıkarma
çıkarmasının	çıkarma
çıkarmasına	çıkarma
çıkarmayı	çıkarma
çıkarmayın	çıkar
çıkarmayınız	çıkar
çıkarmaya	çıkar
çıkarmaz	çıkar
çıkarsın	çık
çıkarsınız	çık
çıkarsa	çıkar
çıkartılıncaya	çıkart
çıkartılıp	çıkart
çıkartılır	çıkart
çıkartılıyor	çıkart
çıkartılabilir	çıkart
çıkartılacak	çıkart
çıkartılacaktır	çıkart
çıkartılamaz	çıkart
çıkartılan	çıkart
çıkartılarak	çıkart
çıkartıldı	çıkart
çıkartıldığı	çıkart
çıkartıldıktan	çıkart
çıkartılmış	çıkart
çıkartılmıştır	çıkart
çıkartılma	çıkart
çıkartılmak	çıkart
çıkartılmalıdır	çıkart
çıkartılması	çıkart
çıkartılmasını	çıkart
çıkartılmasına	çıkart
çıkartılmasında	çıkart
çıkartın	çıkart
çıkartıp	çıkart
çıkartır	çıkart
çıkartırken	çıkart
çıkartırlar	çıkart
çıkartıyor	çıkart
çıkartıyorlar	çıkart
çıkartıyoruz	çıkart
çıkartabilir	çıkart
çıkartabilirler	çıkart
çıkartabilirsiniz	çıkart
çıkartacağı	çıkart
çıkartacak	çıkart
çıkartan	çıkart
çıkartarak	çıkart
çıkartmış	çıkart
çıkartmıştı	çıkart
çıkartmıştır	çıkart
çıkartma	çıkart
çıkartmadan	çıkart
çıkartmak	çıkart
çıkartmalar	çıkart
çıkartmaları	çıkart
çıkartmayı	çıkart
çıkartmaya	çıkart
çıkarttı	çıkart
çıkarttığı	çıkart
çıkarttığım	çıkart
çıkarttığını	çıkart
çıkarttık	çıkart
çıkarttıkları	çıkart
çıkarttım	çıkart
çıkayım	çık
çıkmış	çık
çıkmışlar	çık
çıkmışlardı	çık
çıkmışsa	çık
çıkmıştı	çık
çıkmıştır	çık
çıkmıyor	çık
çıkmıyordu	çık
çıkmıyorlar	çık
çıkma	çıkma
çıkmadı	çık
çıkmadığı	çık
çıkmadığını	çık
çıkmadan	çık
çıkmak	çık
çıkmakla	çık
çıkmaktır	çık
çıkmakta	çık
çıkmaktadır	çık
çıkmaktadırlar	çık
çıkmaktan	çık
çıkmalı	çık
çıkmalıdır	çık
çıkmalıyız	çık
çıkmalar	çıkma
çıkmaları	çıkma
çıkmalarını	çıkma
çıkmalarına	çıkma
çıkmam	çık
çıkmamış	çık
çıkmamıştı	çık
çıkmamıştır	çık
çıkmamız	çıkma
çıkmama	çıkma
çıkmamak	çık
çıkmaması	çık
çıkmamasını	çık
çıkmamasına	çık
çıkmanın	çıkma
çıkmanız	çıkma
çıkmanızı	çıkma
çıkmanıza	çıkma
çıkması	çıkma
çıkmasıdır	çıkma
çıkmasın	çık
çıkmasını	çıkma
çıkmasının	çıkma
çıkmasına	çıkma
çıkmasında	çıkma
çıkmasından	çıkma
çıkmasıyla	çıkma
çıkmayı	çıkma
çıkmayın	çık
çıkmayınca	çık
çıkmaya	çık
çıkmayacağı	çık
çıkmayacağını	çık
çıkmayacak	çık
çıkmayan	çık
çıkmaz	çıkmaz
çıkmazı	çıkmaz
çıkmazın	çıkmaz
çıkmaza	çıkmaz
çıkmazdı	çıkmaz
çıkmazda	çıkmaz
çıkmazdan	çıkmaz
çıkmazlar	çık
çıkmazsa	çıkmaz
çıksın	çık
çıksa	çık
çıksaydı	çık
çıktı	çık
çıktığı	çık
çıktığım	çık
çıktığımız	çık
çıktığımızı	çık
çıktığımızda	çık
çıktığımda	çık
çıktığını	çık
çıktığınız	çık
çıktığınızda	çık
çıktığına	çık
çıktığında	çık
çıktığından	çık
çıktık	çık
çıktıkça	çık
çıktıkları	çık
çıktıklarını	çık
çıktıklarında	çık
çıktıktan	çık
çıktılar	çık
çıktıları	çıktı
çıktıların	çıktı
çıktılarını	çıktı
çıktılarının	çıktı
çıktım	çık
çıktın	çık
çıktının	çıktı
çıktınız	çık
çıktısı	çıktı
çıktısını	çıktı
çıktısının	çıktı
çıktıyı	çıktı
çıktıysa	çık
çıldır	çıldır
çın	çın
çınar	çınar
çınarın	çınar
çınarcık	çınarcık
çınarlı	çınarlı
çınarlık	çınarlık
çınarlar	çınar
çınaroğlu	çınaroğlu
çınlıyor	çınl
çınlıyordu	çınl
çınlama	çınla
çınlaması	çınla
çıpa	çıpa
çıplak	çıplak
çıplaklığı	çıplak
çıplaklığıyla	çıplak
çıplaklık	çıplak
çıplaktır	çıplak
çırçır	çırçır
çırçırlama	çırçırla
çırılçıplak	çırılçıplak
çıra	çır
çırağı	çırağ
çırağın	çırağ
çırağa	çırağ
çırağan	çırağan
çırak	çırak
çıraklığa	çırak
çıraklık	çırak
çıraklıktan	çırak
çıraklar	çırak
çırakların	çırak
çıralı	çıralı
çırpı	çırpı
çırpıcı	çırpıcı
çırpıda	çırpı
çırpılmış	çırp
çırpın	çırp
çırpınır	çırpın
çırpınan	çırpın
çırpıp	çırp
çırpan	çırp
çırpar	çırp
çırparak	çırp
çıt	çıt
çıtır	çıtır
çıta	çıt
çıtalar	çıta
çıtaları	çıta
çıtasını	çıta
çıtayı	çıta
çöküş	çöküş
çöküşü	çök
çöküşün	çöküş
çöküşünü	çök
çöküşünden	çök
çöküşüne	çöküş
çöküşe	çöküş
çökük	çökük
çöküntü	çöküntü
çöküntüler	çöküntü
çöküntüye	çöküntü
çöküp	çök
çöküyor	çök
çökecek	çök
çökel	çökel
çökelek	çökelek
çökelen	çökel
çökelim	çök
çökeller	çökel
çökelleri	çökel
çökellerin	çökel
çökellerinin	çökel
çökelme	çökel
çökelti	çökelti
çökeltme	çökel
çöken	çök
çöker	çök
çökerek	çök
çökerse	çöker
çökertme	çökertme
çökertmek	çöker
çökkünlük	çökkün
çökmüş	çök
çökmüştü	çök
çökmüştür	çök
çökme	çök
çökmeler	çökme
çökmeleri	çökme
çökmesi	çökme
çökmesine	çökme
çökmesini	çökme
çökmesinin	çökme
çökmesiyle	çökme
çökmeye	çök
çöktü	çök
çöktüğünü	çök
çöktüğünde	çök
çöktürücüler	çök
çöktürme	çök
çöl	çöl
çölü	çöl
çölün	çöl
çölüne	çöl
çölaşan	çölaşan
çölde	çöl
çöldeki	çöl
çöle	çöl
çölleşme	çöl
çöller	çöl
çöllerde	çöl
çöllere	çöl
çölleri	çöl
çöllerinde	çöl
çömelerek	çömel
çömlek	çömlek
çömlekçi	çömlekçi
çömlekçilik	çömlekçi
çöp	çöp
çöpçü	çöpçü
çöpü	çöp
çöpün	çöp
çöpe	çöp
çöplüğü	çöplüğ
çöplüğün	çöplüğ
çöplüğe	çöplüğ
çöplük	çöplük
çöplükte	çöplük
çöpler	çöp
çöpleri	çöp
çöplerimizi	çöp
çöplerin	çöp
çöplerini	çöp
çöreği	çöreğ
çörek	çörek
çörekçi	çörekçi
çörekler	çörek
çöz	çöz
çözücü	çöz
çözücüdür	çöz
çözücüler	çöz
çözücülerde	çöz
çözücülerin	çöz
çözücünün	çöz
çözülüp	çöz
çözülür	çöz
çözülürken	çöz
çözülüyor	çöz
çözülüyordu	çöz
çözüldü	çöz
çözüldüğü	çöz
çözülebileceğini	çöz
çözülebilecek	çöz
çözülebilen	çöz
çözülebilir	çöz
çözülebiliyor	çöz
çözülebilmektedir	çöz
çözülebilmesi	çöz
çözüleceği	çöz
çözüleceğine	çöz
çözüleceğini	çöz
çözülecek	çöz
çözülecektir	çöz
çözülememesi	çöz
çözülememiştir	çöz
çözülemeyecek	çöz
çözülemeyen	çöz
çözülemez	çöz
çözülen	çöz
çözülerek	çöz
çözülmüş	çöz
çözülmüştür	çöz
çözülme	çöz
çözülmeden	çöz
çözülmediği	çöz
çözülmek	çöz
çözülmektedir	çöz
çözülmelidir	çöz
çözülmemiş	çöz
çözülmesi	çöz
çözülmesidir	çöz
çözülmesinde	çöz
çözülmesinden	çöz
çözülmesine	çöz
çözülmesini	çöz
çözülmeye	çöz
çözülmeyen	çöz
çözülmez	çöz
çözüm	çöz
çözümü	çöz
çözümüdür	çözüm
çözümün	çöz
çözümünü	çözüm
çözümünün	çözüm
çözümünde	çözüm
çözümündeki	çözüm
çözümünden	çözüm
çözümüne	çözüm
çözümüyle	çözüm
çözümdür	çöz
çözümde	çöz
çözümden	çöz
çözüme	çöz
çözümlü	çözüm
çözümle	çöz
çözümleme	çözümle
çözümlemede	çözümle
çözümlemek	çözümle
çözümlemeler	çözümle
çözümlemeleri	çözümle
çözümlemenin	çözümle
çözümlemesi	çözümle
çözümlemeye	çözümle
çözümlenebileceğini	çözümle
çözümlenebilecek	çözümle
çözümlenebilir	çözümle
çözümleneceğini	çözümle
çözümlenecektir	çözümle
çözümlenerek	çözümle
çözümlenir	çözümle
çözümlenmektedir	çözümle
çözümlenmemiş	çözümle
çözümlenmesi	çözümle
çözümlenmesinde	çözümle
çözümlenmesine	çözümle
çözümlenmesini	çözümle
çözümlenmesinin	çözümle
çözümlenmiş	çözümle
çözümlenmiştir	çözümle
çözümler	çözüm
çözümlerde	çözüm
çözümlerden	çözüm
çözümlerdir	çözümle
çözümlere	çözüm
çözümleri	çözüm
çözümlerimiz	çözüm
çözümlerimizi	çözüm
çözümlerin	çözüm
çözümlerinde	çözüm
çözümlerinden	çözüm
çözümlerine	çözüm
çözümlerini	çözüm
çözümlerinin	çözüm
çözümleriyle	çözüm
çözümlerle	çözüm
çözümleyen	çözümle
çözümleyici	çözümle
çözümsüz	çözüm
çözümsüzlüğe	çözüm
çözümsüzlük	çözüm
çözün	çöz
çözünür	çözün
çözünürlüğü	çözünürlüğ
çözünürlüğünü	çözünürlüğ
çözünürlüğünün	çözünürlüğ
çözünürlüğünde	çözünürlüğ
çözünürlüğüne	çözünürlüğ
çözünürlüğe	çözünürlüğ
çözünürlüğü	çözünürlüğ
çözünürlük	çözünürlük
çözünürlüklü	çözünürlük
çözünürlüklerde	çözünürlük
çözünürlükleri	çözünürlük
çözünürlükte	çözünürlük
çözünüz	çöz
çözündürme	çözün
çözünebilir	çözün
çözünen	çözün
çözünerek	çözün
çözünmüş	çözün
çözünme	çözün
çözünmesi	çözün
çözünmeyen	çözün
çözünmez	çözün
çözüp	çöz
çözüyor	çöz
çözüyoruz	çöz
çözdü	çöz
çözdük	çöz
çözdükten	çöz
çözdüler	çöz
çözdüm	çöz
çözebilecek	çöz
çözebilen	çöz
çözebilir	çöz
çözebiliriz	çöz
çözebilirler	çöz
çözebilirsiniz	çöz
çözebilme	çöz
çözebilmek	çöz
çözeceğine	çöz
çözeceğini	çöz
çözeceğiz	çöz
çözecek	çöz
çözecektir	çöz
çözelim	çöz
çözelti	çözelti
çözeltide	çözelti
çözeltiden	çözelti
çözeltiler	çözelti
çözeltilerde	çözelti
çözeltileri	çözelti
çözeltilerin	çözelti
çözeltilerinin	çözelti
çözeltinin	çözelti
çözeltisi	çözelti
çözeltisinden	çözelti
çözeltisine	çözelti
çözeltiye	çözelti
çözemediği	çöz
çözemez	çöz
çözen	çöz
çözer	çöz
çözerek	çöz
çözeriz	çöz
çözerken	çöz
çözerler	çöz
çözmüş	çöz
çözmüştür	çöz
çözme	çöz
çözmede	çöz
çözmeden	çöz
çözmek	çöz
çözmekle	çöz
çözmekte	çöz
çözmektedir	çöz
çözmekten	çöz
çözmektir	çöz
çözmeleri	çöz
çözmelidir	çöz
çözmemiz	çöz
çözmenin	çöz
çözmesi	çöz
çözmesini	çöz
çözmeye	çöz
çözmeyi	çöz
çözmez	çöz
çü	çü
çünkü	çünkü
çünki	çünki
çürüğü	çürüğ
çürüğe	çürüğ
çürük	çürük
çürüklüğü	çürük
çürüklük	çürük
çürükler	çürük
çürükleri	çürük
çürüksu	çürüksu
çürümüş	çürü
çürüme	çürü
çürümeden	çürü
çürümenin	çürü
çürümesi	çürü
çürümeye	çürü
çürümez	çürü
çürür	çürü
çürütme	çürü
çürütmek	çürü
çürüyen	çürü
çaça	çaça
çağ	çağ
çağ'ın	çağ
çağ'da	çağ
çağı	çağ
çağı'nın	çağı
çağı'na	çağı
çağı'nda	çağı
çağıdır	çağ
çağımız	çağ
çağımızın	çağ
çağımıza	çağ
çağımızda	çağ
çağımızdaki	çağ
çağın	çağ
çağını	çağ
çağının	çağ
çağına	çağ
çağında	çağ
çağındaki	çağ
çağından	çağ
çağır	çağır
çağırın	çağır
çağırıp	çağır
çağırır	çağır
çağırırlar	çağır
çağırıyor	çağır
çağırıyordu	çağır
çağırıyorlar	çağır
çağırıyorum	çağır
çağırıyoruz	çağır
çağıra	çağır
çağırabileceğiniz	çağır
çağırabilir	çağır
çağırabilirsiniz	çağır
çağıracağınız	çağır
çağıracak	çağır
çağıran	çağır
çağırarak	çağır
çağırdı	çağır
çağırdığı	çağır
çağırdığını	çağır
çağırdığınız	çağır
çağırdık	çağır
çağırdılar	çağır
çağırdım	çağır
çağırmış	çağır
çağırmıştı	çağır
çağırma	çağır
çağırmadan	çağır
çağırmak	çağır
çağırması	çağır
çağırttı	çağır
çağa	çağ
çağan	çağ
çağatay	çağatay
çağcıl	çağcıl
çağdışı	çağdış
çağda	çağ
çağdaş	çağdaş
çağdaşlığı	çağdaş
çağdaşlığın	çağdaş
çağdaşlığa	çağdaş
çağdaşlık	çağdaş
çağdaşlaşma	çağdaş
çağdaşlaşmanın	çağdaş
çağdaşlaşmayı	çağdaş
çağdaki	çağ
çağdan	çağ
çağla	çağ
çağlar	çağ
çağlar'ın	çağlar
çağlar'a	çağlar
çağlar'da	çağlar
çağları	çağ
çağların	çağ
çağlarına	çağ
çağlarında	çağ
çağlara	çağ
çağlarda	çağ
çağlardan	çağ
çağlayan	çağla
çağlayanlar	çağlayan
çağrı	çağrı
çağrışım	çağrışım
çağrışımı	çağrışım
çağrışımlar	çağrışım
çağrıştırır	çağrış
çağrıştırıyor	çağrış
çağrıştıracak	çağrış
çağrıştıran	çağrış
çağrıştırdı	çağrış
çağrıştırdığı	çağrış
çağrıda	çağrı
çağrılı	çağrı
çağrılıp	çağrıl
çağrılır	çağrıl
çağrılabilir	çağrıl
çağrılacak	çağrıl
çağrılan	çağrıl
çağrılar	çağrı
çağrıları	çağrı
çağrıların	çağrı
çağrılarını	çağrı
çağrılarına	çağrı
çağrılara	çağrı
çağrılarak	çağrıl
çağrıldı	çağrıl
çağrıldığı	çağrıl
çağrıldığını	çağrıl
çağrıldığında	çağrıl
çağrılmış	çağrıl
çağrılması	çağrıl
çağrılmasını	çağrıl
çağrının	çağrı
çağrısı	çağrı
çağrısını	çağrı
çağrısının	çağrı
çağrısına	çağrı
çağrısında	çağrı
çağrısıyla	çağrı
çağrıyı	çağrı
çağrıya	çağrı
çağsan	çağ
çaba	çaba
çabadır	çaba
çabada	çaba
çabadan	çaba
çabalıyor	çabal
çabalıyoruz	çabal
çabalar	çaba
çabaları	çaba
çabalarımız	çaba
çabalarımızı	çaba
çabalarımızın	çaba
çabalarımıza	çaba
çabaların	çaba
çabalarını	çaba
çabalarının	çaba
çabalarınız	çaba
çabalarına	çaba
çabalarında	çaba
çabalarından	çaba
çabalarıyla	çaba
çabalara	çaba
çabalarda	çaba
çabalardan	çaba
çabalarken	çabala
çabalarla	çaba
çabalayan	çabala
çabamız	çaba
çabanın	çaba
çabası	çaba
çabasıdır	çaba
çabasını	çaba
çabasının	çaba
çabasına	çaba
çabasında	çaba
çabasından	çaba
çabasıyla	çaba
çabayı	çaba
çabaya	çaba
çabayla	çaba
çabucak	çabucak
çabuk	çabuk
çabukluğu	çabuk
çabukluk	çabuk
çadır	çadır
çadırı	çadır
çadırın	çadır
çadırınızı	çadır
çadırına	çadır
çadırında	çadır
çadıra	çadır
çadırcı	çadırcı
çadırda	çadır
çadırdan	çadır
çadırkent	çadırkent
çadırkenti	çadırkent
çadırkentlerde	çadırkent
çadırkentte	çadırkent
çadırlı	çadırlı
çadırlar	çadır
çadırları	çadır
çadırların	çadır
çadırlarını	çadır
çadırlarında	çadır
çadırlara	çadır
çadırlarda	çadır
çağ	çağ
çağa	çağ
çağda	çağ
çağdaş	çağdaş
çağlar	çağ
çağlardan	çağ
çağlayan	çağla
çak	çak
çakı	çakı
çakışır	çakış
çakışan	çakış
çakışma	çakış
çakışması	çakış
çakıştığı	çakış
çakıcı	çakıcı
çakıl	çakıl
çakılı	çakıl
çakılıp	çakıl
çakıllı	çakıllı
çakır	çakır
çakıroğlu	çakıroğlu
çakısı	çakı
çaka	çak
çakal	çakal
çakan	çak
çakar	çak
çakar'ın	çakar
çakma	çakma
çakmağı	çakmağ
çakmak	çakmak
çakmakçı	çakmakçı
çakmaklı	çakmaklı
çakmaları	çakma
çakmalarının	çakma
çakması	çakma
çakmaya	çak
çaktı	çak
çal	çal
çalı	çal
çalış	çalış
çalışılır	çalış
çalışılırdı	çalış
çalışılırken	çalış
çalışılırsa	çalış
çalışılıyor	çalış
çalışılıyordu	çalış
çalışılabilir	çalış
çalışılacak	çalış
çalışılacaktır	çalış
çalışılan	çalış
çalışılarak	çalış
çalışıldı	çalış
çalışıldığı	çalış
çalışıldığını	çalış
çalışıldığında	çalış
çalışılmış	çalış
çalışılmıştı	çalış
çalışılmıştır	çalış
çalışılmıyor	çalış
çalışılmakta	çalış
çalışılmaktadır	çalış
çalışılmalı	çalış
çalışılmalıdır	çalış
çalışılması	çalış
çalışılmasını	çalış
çalışılmaya	çalış
çalışılsa	çalış
çalışın	çalış
çalışınız	çalış
çalışınca	çalış
çalışıp	çalış
çalışır	çalış
çalışırım	çalış
çalışırız	çalış
çalışırdı	çalış
çalışırdık	çalış
çalışırdım	çalış
çalışırken	çalış
çalışırlar	çalış
çalışırlardı	çalış
çalışırmış	çalış
çalışırsınız	çalış
çalışırsa	çalış
çalışırsak	çalış
çalışırsanız	çalış
çalışıyor	çalış
çalışıyordu	çalış
çalışıyorduk	çalış
çalışıyordum	çalış
çalışıyorlar	çalış
çalışıyorlardı	çalış
çalışıyormuş	çalış
çalışıyorsa	çalış
çalışıyorsanız	çalış
çalışıyorsun	çalış
çalışıyorsunuz	çalış
çalışıyorum	çalış
çalışıyoruz	çalış
çalışabildiği	çalış
çalışabileceği	çalış
çalışabileceğini	çalış
çalışabilecek	çalış
çalışabilecekleri	çalış
çalışabilen	çalış
çalışabilir	çalış
çalışabiliriz	çalış
çalışabilirler	çalış
çalışabilirsiniz	çalış
çalışabiliyor	çalış
çalışabilme	çalış
çalışabilmek	çalış
çalışabilmektedir	çalış
çalışabilmektedirler	çalış
çalışabilmeleri	çalış
çalışabilmesi	çalış
çalışabilmesini	çalış
çalışacağı	çalış
çalışacağım	çalış
çalışacağımız	çalış
çalışacağını	çalış
çalışacağınız	çalış
çalışacağına	çalış
çalışacağız	çalış
çalışacak	çalış
çalışacaklar	çalış
çalışacakları	çalış
çalışacaklarını	çalış
çalışacaklardır	çalış
çalışacaksınız	çalış
çalışacaktır	çalış
çalışalım	çalış
çalışamayacak	çalış
çalışamaz	çalış
çalışamazlar	çalış
çalışan	çalış
çalışanı	çalışan
çalışanımızın	çalışan
çalışanın	çalışan
çalışanının	çalışan
çalışanına	çalışan
çalışanıyla	çalışan
çalışana	çalışan
çalışandan	çalışan
çalışanla	çalışan
çalışanlar	çalışan
çalışanları	çalışan
çalışanlarımız	çalışan
çalışanlarımızı	çalışan
çalışanlarımızın	çalışan
çalışanlarımıza	çalışan
çalışanlarımızla	çalışan
çalışanların	çalışan
çalışanlarını	çalışan
çalışanlarının	çalışan
çalışanlarınız	çalışan
çalışanlarınızı	çalışan
çalışanlarınızın	çalışan
çalışanlarına	çalışan
çalışanlarında	çalışan
çalışanlarından	çalışan
çalışanlarıyla	çalışan
çalışanlara	çalışan
çalışanlarda	çalışan
çalışanlardan	çalışan
çalışanlarla	çalışan
çalışarak	çalış
çalışayım	çalış
çalışkan	çalışkan
çalışkan'ın	çalışkan
çalışkandır	çalışkan
çalışkanlığı	çalışkan
çalışkanlık	çalışkan
çalışlar	çalış
çalışmış	çalış
çalışmışlar	çalış
çalışmışlardı	çalış
çalışmışlardır	çalış
çalışmıştı	çalış
çalışmıştır	çalış
çalışmıyor	çalış
çalışmıyorsa	çalış
çalışma	çalış
çalışmacı	çalış
çalışmadığı	çalış
çalışmadığını	çalış
çalışmadığından	çalış
çalışmadım	çalış
çalışmadır	çalış
çalışmada	çalış
çalışmadaki	çalış
çalışmadan	çalış
çalışmak	çalış
çalışmakla	çalış
çalışmaktı	çalış
çalışmaktır	çalış
çalışmakta	çalış
çalışmaktadır	çalış
çalışmaktadırlar	çalış
çalışmaktan	çalış
çalışmaktayım	çalış
çalışmaktayız	çalış
çalışmaktaydı	çalış
çalışmalı	çalış
çalışmalıdır	çalış
çalışmalıdırlar	çalış
çalışmalısınız	çalış
çalışmalıyız	çalış
çalışmalar	çalış
çalışmaları	çalış
çalışmalarıdır	çalış
çalışmalarım	çalış
çalışmalarımı	çalış
çalışmalarımız	çalış
çalışmalarımızı	çalış
çalışmalarımızın	çalış
çalışmalarımıza	çalış
çalışmalarımızda	çalış
çalışmalarımızdan	çalış
çalışmalarımızla	çalış
çalışmalarıma	çalış
çalışmaların	çalış
çalışmalarını	çalış
çalışmalarının	çalış
çalışmalarınız	çalış
çalışmalarınızı	çalış
çalışmalarınızın	çalış
çalışmalarınıza	çalış
çalışmalarınızda	çalış
çalışmalarınızdan	çalış
çalışmalarına	çalış
çalışmalarında	çalış
çalışmalarındaki	çalış
çalışmalarından	çalış
çalışmalarıyla	çalış
çalışmalara	çalış
çalışmalardı	çalış
çalışmalardır	çalış
çalışmalarda	çalış
çalışmalardaki	çalış
çalışmalardan	çalış
çalışmalarla	çalış
çalışmam	çalış
çalışmamı	çalış
çalışmamış	çalış
çalışmamız	çalış
çalışmamızı	çalış
çalışmamızın	çalış
çalışmamıza	çalış
çalışmamızda	çalış
çalışmama	çalış
çalışmamak	çalış
çalışmamaktadır	çalış
çalışmaması	çalış
çalışmanın	çalış
çalışmanız	çalış
çalışmanızı	çalış
çalışmanızın	çalış
çalışmanıza	çalış
çalışması	çalış
çalışmasıdır	çalış
çalışmasını	çalış
çalışmasının	çalış
çalışmasına	çalış
çalışmasında	çalış
çalışmasındaki	çalış
çalışmasından	çalış
çalışmasıyla	çalış
çalışmayı	çalış
çalışmayın	çalış
çalışmayınız	çalış
çalışmaya	çalış
çalışmayabilir	çalış
çalışmayan	çalış
çalışmayanlar	çalış
çalışmayla	çalış
çalışmaz	çalış
çalışmazlar	çalış
çalışmazsa	çalış
çalışsın	çalış
çalışsınlar	çalış
çalışsa	çalış
çalışsak	çalış
çalışsalar	çalış
çalıştı	çalış
çalıştığı	çalış
çalıştığım	çalış
çalıştığımı	çalış
çalıştığımız	çalış
çalıştığımızı	çalış
çalıştığımda	çalış
çalıştığını	çalış
çalıştığının	çalış
çalıştığınız	çalış
çalıştığınızı	çalış
çalıştığınızda	çalış
çalıştığına	çalış
çalıştığında	çalış
çalıştığından	çalış
çalıştık	çalış
çalıştıkça	çalış
çalıştıkları	çalış
çalıştıklarını	çalış
çalıştıklarına	çalış
çalıştıklarında	çalış
çalıştıklarından	çalış
çalıştıktan	çalış
çalıştılar	çalış
çalıştım	çalış
çalıştınız	çalış
çalıştır	çalış
çalıştırıcı	çalış
çalıştırıcısı	çalış
çalıştırılır	çalış
çalıştırılırlar	çalış
çalıştırılıyor	çalış
çalıştırılabilir	çalış
çalıştırılabilmesi	çalış
çalıştırılacağı	çalış
çalıştırılacak	çalış
çalıştırılacakların	çalış
çalıştırılacaktır	çalış
çalıştırılamaz	çalış
çalıştırılamazlar	çalış
çalıştırılan	çalış
çalıştırılarak	çalış
çalıştırıldı	çalış
çalıştırıldığı	çalış
çalıştırıldığında	çalış
çalıştırıldıktan	çalış
çalıştırılmış	çalış
çalıştırılma	çalış
çalıştırılmak	çalış
çalıştırılmakta	çalış
çalıştırılmaktadır	çalış
çalıştırılmaktadırlar	çalış
çalıştırılmalıdır	çalış
çalıştırılmaları	çalış
çalıştırılması	çalış
çalıştırılmasını	çalış
çalıştırılmasına	çalış
çalıştırılmaya	çalış
çalıştırın	çalış
çalıştırınız	çalış
çalıştırıp	çalış
çalıştırır	çalış
çalıştırırken	çalış
çalıştırırsanız	çalış
çalıştırıyor	çalış
çalıştırabilecek	çalış
çalıştırabilir	çalış
çalıştırabilirler	çalış
çalıştırabilirsiniz	çalış
çalıştırabilmek	çalış
çalıştıracak	çalış
çalıştıramaz	çalış
çalıştıran	çalış
çalıştıranlar	çalış
çalıştıranlara	çalış
çalıştırarak	çalış
çalıştırdığı	çalış
çalıştırdığınız	çalış
çalıştırdığınızda	çalış
çalıştırdıkları	çalış
çalıştırdıktan	çalış
çalıştırma	çalış
çalıştırmadan	çalış
çalıştırmak	çalış
çalıştırmakla	çalış
çalıştırmaktadır	çalış
çalıştırmaları	çalış
çalıştırmanız	çalış
çalıştırması	çalış
çalıştırmayı	çalış
çalıştırmayınız	çalış
çalıştırmaya	çalış
çalıştay	çalıştay
çalıdır	çal
çalık	çalık
çalıkuşu	çalıkuş
çalılar	çalı
çalıların	çalı
çalınır	çalın
çalınırsa	çalın
çalınıyor	çalın
çalınan	çalın
çalındı	çalın
çalındığı	çalın
çalındığını	çalın
çalındığında	çalın
çalınmış	çalın
çalınma	çalın
çalınmaktadır	çalın
çalınması	çalın
çalınmaya	çalın
çalıntı	çalıntı
çalıp	çal
çalıyor	çal
çalıyordu	çal
çalıyorum	çal
çalıyoruz	çal
çalabilir	çal
çalacak	çal
çalan	çal
çalar	çal
çalarak	çal
çalardı	çalar
çalarken	çal
çalarlar	çal
çaldı	çal
çaldığı	çal
çaldığını	çal
çaldığında	çal
çaldık	çal
çaldıkları	çal
çaldılar	çal
çaldım	çal
çaldıran	çaldıran
çalkalama	çalkala
çalkalanır	çalkala
çalkantı	çalkantı
çalkantılı	çalkantı
çalkantılar	çalkantı
çallı	çallı
çallı'nın	çallı
çalmış	çal
çalmıştı	çal
çalma	çalma
çalmadan	çal
çalmak	çal
çalmakta	çal
çalması	çalma
çalmasını	çalma
çalmayı	çalma
çalmaya	çal
çalmaz	çal
çam	çam
çamı	çam
çamaşır	çamaşır
çamaşırı	çamaşır
çamaşırhane	çamaşırhane
çamaşırlar	çamaşır
çamaşırları	çamaşır
çamaşırların	çamaşır
çamaşırlarını	çamaşır
çamaşırlarının	çamaşır
çamaşırlarınızın	çamaşır
çamaşırlarda	çamaşır
çamaltı	çamaltı
çamardı	çamardı
çamdibi	çamdibi
çameli	çameli
çamkonak	çamkonak
çamlı	çamlı
çamlığı	çamlığ
çamlıbel	çamlıbel
çamlıca	çamlı
çamlıhemşin	çamlıhemşin
çamlık	çamlık
çamların	çam
çamlaraltı	çamlaraltı
çamur	çamur
çamura	çamur
çamurda	çamur
çamurdan	çamur
çamurla	çamur
çamurlar	çamur
çamurları	çamur
çamurların	çamur
çamurlarının	çamur
çamurlu	çamurlu
çamuru	çamur
çamurun	çamur
çamurunun	çamur
çamyar	çamyar
çamyuva	çamyuva
çan	çan
çanağın	çanağ
çanağına	çanağ
çanak	çanak
çanakkale	çanakkale
çanakkale'de	çanakkale
çanakkale'deki	çanakkale
çanakkale'den	çanakkale
çanakkale'nin	çanakkale
çanakkale'ye	çanakkale
çandar	çandar
çandar'ın	çandar
çandarlı	çandarlı
çankırı	çankırı
çankırı'da	çankırı
çankırı'nın	çankırı
çankırı'ya	çankırı
çankaya	çankaya
çankaya'da	çankaya
çankaya'dan	çankaya
çankaya'ya	çankaya
çanlar	çan
çanları	çan
çanta	çanta
çantada	çanta
çantalı	çanta
çantalar	çanta
çantaları	çanta
çantalarımızı	çanta
çantaların	çanta
çantalarından	çanta
çantamı	çanta
çantanın	çanta
çantanız	çanta
çantanızı	çanta
çantanızın	çanta
çantanızda	çanta
çantası	çanta
çantasını	çanta
çantasına	çanta
çantasında	çanta
çantasından	çanta
çantay	çantay
çantayı	çanta
çantaya	çanta
çap	çap
çapı	çap
çapını	çap
çapının	çap
çapına	çap
çapında	çap
çapındadır	çap
çapındaki	çap
çapından	çap
çapa	çap
çapak	çapak
çapan	çap
çapan'ın	çap
çaplı	çap
çapları	çap
çaplarında	çap
çaplarda	çap
çapraz	çapraz
çaprazlama	çaprazlama
çapta	çap
çaptaki	çap
çaptan	çap
çar	çar
çarçabuk	çarçabuk
çarçur	çarçur
çarı	çar
çarık	çarık
çarşı	çarşı
çarşı'da	çarşı
çarşıda	çarşı
çarşıdaki	çarşı
çarşıdan	çarşı
çarşılar	çarşı
çarşıları	çarşı
çarşıların	çarşı
çarşılarda	çarşı
çarşının	çarşı
çarşısı	çarşı
çarşısı'nın	çarşısı
çarşısının	çarşı
çarşısında	çarşı
çarşıyı	çarşı
çarşıya	çarşı
çarşaf	çarşaf
çarşafı	çarşaf
çarşafın	çarşaf
çarşafla	çarşaf
çarşak	çarşak
çarşamba	çarşamba
çardak	çardak
çare	çare
çareler	çare
çareleri	çare
çarelerini	çare
çaremiz	çare
çaresi	çare
çaresine	çare
çaresini	çare
çaresinin	çare
çaresiz	çare
çaresizliğe	çare
çaresizliğin	çare
çaresizliğini	çare
çaresizlik	çare
çaresizlikten	çare
çareyi	çare
çark	çark
çarkı	çark
çarkın	çark
çarkının	çark
çarklar	çark
çarkları	çark
çarkların	çark
çarlık	çar
çarmıha	çarmıh
çarpı	çarpı
çarpışan	çarpış
çarpışarak	çarpış
çarpışmış	çarpış
çarpışma	çarpış
çarpışmada	çarpış
çarpışmadan	çarpış
çarpışmalar	çarpış
çarpışmaları	çarpış
çarpışmaların	çarpış
çarpışmalara	çarpış
çarpışmalarda	çarpış
çarpışması	çarpış
çarpıcı	çarp
çarpıcıdır	çarp
çarpık	çarpık
çarpıklık	çarpık
çarpıklıklar	çarpık
çarpıklıkları	çarpık
çarpılıp	çarpıl
çarpılır	çarpıl
çarpılacağı	çarpıl
çarpılarak	çarpıl
çarpılması	çarpıl
çarpım	çarpı
çarpımı	çarpı
çarpımının	çarpım
çarpımından	çarpım
çarpımları	çarpım
çarpıntı	çarpıntı
çarpıp	çarp
çarpıtılmış	çarpıt
çarpıtma	çarpıt
çarpıyor	çarp
çarpıyordu	çarp
çarpa	çarp
çarpacak	çarp
çarpan	çarp
çarpanı	çarp
çarpanlar	çarp
çarpanları	çarp
çarpar	çarp
çarparak	çarp
çarpmış	çarp
çarpma	çarp
çarpmadan	çarp
çarpmak	çarp
çarpmaktadır	çarp
çarpmalarda	çarpma
çarpmanın	çarpma
çarpması	çarpma
çarpmasına	çarpma
çarpmaya	çarp
çarptı	çarp
çarptığı	çarp
çarptığında	çarp
çarptıktan	çarp
çarptırılır	çarp
çarptırılan	çarp
çarptırıldı	çarp
çarptırılmış	çarp
çat	çat
çatı	çat
çatışır	çatış
çatışan	çatış
çatışma	çatış
çatışmada	çatış
çatışmadan	çatış
çatışmalar	çatış
çatışmaları	çatış
çatışmaların	çatış
çatışmalarının	çatış
çatışmalarına	çatış
çatışmalara	çatış
çatışmalarda	çatış
çatışmalardan	çatış
çatışmanın	çatış
çatışması	çatış
çatışmasını	çatış
çatışmasının	çatış
çatışmasına	çatış
çatışmayı	çatış
çatışmaya	çatış
çatıştığı	çatış
çatıda	çatı
çatıdaki	çatı
çatıdan	çatı
çatık	çatık
çatılı	çatılı
çatılar	çatı
çatıları	çatı
çatıların	çatı
çatılarına	çatı
çatılarda	çatı
çatının	çat
çatır	çatır
çatısı	çatı
çatısını	çatı
çatısının	çatı
çatısına	çatı
çatısında	çatı
çatıyı	çatı
çatıya	çatı
çatak	çatak
çatal	çatal
çatalı	çat
çatalağzı	çatalağz
çatalca	çatal
çatalca'da	çatalca
çatalca'ya	çatalca
çatalhöyük	çatalhöyük
çatallı	çatallı
çatalla	çatal
çatalzeytin	çatalzeytin
çatkı	çatkı
çatlağı	çatlağ
çatlağın	çatlağ
çatlak	çatlak
çatlaklar	çatlak
çatlakları	çatlak
çatlakların	çatlak
çatlaklara	çatlak
çatlaklarda	çatlak
çatlaklardan	çatlak
çatlamış	çatla
çatlama	çatla
çatlamalar	çatla
çatlamalara	çatla
çatlamaz	çatla
çatlar	çat
çatlayan	çatla
çatma	çat
çatom	çato
çattı	çat
çavan	çav
çavdar	çavdar
çavuş	çavuş
çavuşbaşı	çavuşbaşı
çavuşbaşı'nın	çavuşbaşı
çavuşbaşı'nda	çavuşbaşı
çavuşlar	çavuş
çavuşoğlu	çavuşoğlu
çavuşun	çavuş
çavundur	çavundur
çay	çay
çayı	çay
çayı'nın	çayı
çayı'na	çayı
çayımı	çay
çayın	çay
çayını	çay
çayının	çay
çayınızı	çay
çayına	çay
çayır	çayır
çayırı	çayır
çayırda	çayır
çayırlar	çayır
çayırları	çayır
çayırova	çayırova
çaya	çay
çaybükü	çaybük
çaybaşı	çaybaşı
çaycı	çay
çaycuma	çaycuma
çayda	çay
çaydanlık	çaydanlık
çayeli	çayeli
çaykara	çaykara
çaykur	çaykur
çayla	çay
çaylak	çaylak
çaylar	çay
çayları	çay
çaylarımızı	çay
çayların	çay
çaylarını	çay
çeçen	çeçe
çeçenistan	çeçenistan
çeçenistan'a	çeçenistan
çeşide	çeşid
çeşidi	çeşid
çeşididir	çeşid
çeşidin	çeşid
çeşidinde	çeşid
çeşidinden	çeşid
çeşidine	çeşid
çeşidini	çeşid
çeşidinin	çeşid
çeşidiyle	çeşid
çeşit	çeşit
çeşitlendirilmesi	çeşit
çeşitlendirilmesine	çeşit
çeşitlendirmek	çeşit
çeşitlendirmesi	çeşit
çeşitlenen	çeşit
çeşitlenmesi	çeşit
çeşitler	çeşit
çeşitlerde	çeşit
çeşitlerden	çeşit
çeşitlere	çeşit
çeşitleri	çeşit
çeşitlerimiz	çeşit
çeşitlerimizi	çeşit
çeşitlerin	çeşit
çeşitlerinde	çeşit
çeşitlerinden	çeşit
çeşitlerine	çeşit
çeşitlerini	çeşit
çeşitlerinin	çeşit
çeşitleriyle	çeşit
çeşitli	çeşitli
çeşitlidir	çeşitli
çeşitliliğe	çeşitli
çeşitliliği	çeşitli
çeşitliliğin	çeşitli
çeşitliliğine	çeşitli
çeşitliliğini	çeşitli
çeşitliliğinin	çeşitli
çeşitlilik	çeşitli
çeşitte	çeşit
çeşitten	çeşit
çeşittir	çeşit
çeşme	çeşme
çeşme'de	çeşme
çeşme'nin	çeşme
çeşme'ye	çeşme
çeşmeden	çeşme
çeşmeler	çeşme
çeşmelerden	çeşme
çeşmeleri	çeşme
çeşmenin	çeşme
çeşmesi	çeşme
çeşmeye	çeşme
çeşni	çeşni
çeşnili	çeşni
çeaş	çeaş
çebi	çebi
çed	çed
çehre	çehre
çehresi	çehre
çehresini	çehre
çehreye	çehre
çek	çek
çekül	çekül
çeke	çek
çekebilecek	çek
çekebilir	çek
çekebilirler	çek
çekebilirsiniz	çek
çekebilme	çek
çekebilmek	çek
çekebilmesi	çek
çekeceğini	çekeceğ
çekeceğiniz	çekeceğ
çekeceğiz	çek
çekecek	çek
çekeceksiniz	çek
çekecektir	çek
çekelim	çek
çekememezlik	çekeme
çekemeyen	çekeme
çekemeyenler	çekeme
çeken	çek
çekene	çek
çekeni	çek
çekenler	çek
çekenlere	çek
çekenlerin	çek
çeker	çek
çekerdi	çek
çekerek	çek
çekerim	çek
çekeriz	çek
çekerken	çek
çekerler	çek
çekerseniz	çek
çekersiniz	çek
çekeyim	çek
çeki	çek
çekiç	çekiç
çekiçle	çekiç
çekiş	çekiş
çekişen	çekiş
çekişi	çekiş
çekişli	çekiş
çekişme	çekiş
çekişmeler	çekiş
çekişmelerden	çekiş
çekişmelere	çekiş
çekişmeleri	çekiş
çekişmelerin	çekiş
çekişmeli	çekiş
çekişmeye	çekiş
çekici	çekici
çekicidir	çekici
çekiciler	çekici
çekiciliği	çekici
çekiciliğini	çekici
çekicilik	çekici
çekicinin	çekic
çekiciydi	çekici
çekiciye	çekici
çekiciyi	çekici
çekidüzen	çekidüzen
çekik	çekik
çekildi	çekil
çekildiği	çekil
çekildiğinde	çekil
çekildiğini	çekil
çekildiği	çekil
çekildik	çekil
çekildikleri	çekil
çekildikten	çekil
çekildiler	çekil
çekilebilen	çekil
çekilebilir	çekil
çekilebilmesi	çekil
çekileceği	çekil
çekilecek	çekil
çekilecektir	çekil
çekilemez	çekil
çekilen	çekil
çekilerek	çekil
çekili	çeki
çekiliş	çekiliş
çekilişe	çekiliş
çekilişi	çekiliş
çekilişle	çekiliş
çekilişte	çekiliş
çekilince	çekil
çekilip	çekil
çekilir	çekil
çekilirdi	çekil
çekilirken	çekil
çekiliyor	çekil
çekiliyordu	çekil
çekilme	çekil
çekilmeden	çekil
çekilmek	çekil
çekilmekte	çekil
çekilmektedir	çekil
çekilmeleri	çekil
çekilmeli	çekil
çekilmelidir	çekil
çekilmenin	çekil
çekilmesi	çekil
çekilmesidir	çekil
çekilmesinden	çekil
çekilmesine	çekil
çekilmesini	çekil
çekilmesinin	çekil
çekilmesiyle	çekil
çekilmeye	çekil
çekilmeyi	çekil
çekilmez	çekil
çekilmiş	çekil
çekilmişlerdir	çekil
çekilmişti	çekil
çekilmiştir	çekil
çekim	çek
çekimde	çek
çekime	çek
çekimi	çek
çekimin	çek
çekiminde	çekim
çekimine	çekim
çekimini	çekim
çekimler	çekim
çekimlerde	çekim
çekimleri	çekim
çekimlerin	çekim
çekimlerinde	çekim
çekimlerine	çekim
çekimlerini	çekim
çekimser	çekimser
çekin	çek
çekince	çek
çekinceler	çekince
çekinceleri	çekince
çekinceye	çekince
çekindi	çekin
çekindiği	çekin
çekindiğim	çekin
çekindikleri	çekin
çekinen	çekin
çekinerek	çekin
çekinir	çekin
çekiniyor	çekin
çekiniz	çek
çekinme	çekin
çekinmeden	çekin
çekinmedi	çekin
çekinmeyen	çekin
çekinmeyin	çekin
çekinmeyiniz	çekin
çekip	çek
çekirdeğe	çekirdeğ
çekirdeği	çekirdeğ
çekirdeğin	çekirdeğ
çekirdeğinde	çekirdeğ
çekirdeğine	çekirdeğ
çekirdeğini	çekirdeğ
çekirdeğinin	çekirdeğ
çekirdek	çekirdek
çekirdekler	çekirdek
çekirdeklerden	çekirdek
çekirdekleri	çekirdek
çekirdeklerin	çekirdek
çekirdeklerinden	çekirdek
çekirdeklerini	çekirdek
çekirdeklerinin	çekirdek
çekirdekli	çekirdekli
çekirdeksiz	çekirdeksiz
çekirdekteki	çekirdek
çekirdekten	çekirdek
çekirdektir	çekirdek
çekiyor	çek
çekiyordu	çek
çekiyorduk	çek
çekiyordum	çek
çekiyorlar	çek
çekiyorlardı	çek
çekiyorsa	çek
çekiyorsanız	çek
çekiyorum	çek
çekiyoruz	çek
çekle	çek
çekler	çek
çeklere	çek
çekleri	çek
çeklerin	çek
çeklerini	çek
çeklerinin	çek
çeklerinizi	çek
çeklerinizin	çek
çeklerle	çek
çekme	çekme
çekmece	çekme
çekmeceler	çekmece
çekmecelerde	çekmece
çekmeceli	çekmece
çekmeden	çek
çekmedi	çek
çekmek	çek
çekmeköy	çekmeköy
çekmekle	çek
çekmekte	çek
çekmektedir	çek
çekmektedirler	çek
çekmekten	çek
çekmektir	çek
çekmeleri	çekme
çekmeli	çek
çekmelidir	çek
çekmemek	çek
çekmemesi	çek
çekmemiş	çek
çekmenin	çekme
çekmeniz	çekme
çekmesi	çekme
çekmesine	çekme
çekmesini	çekme
çekmeye	çek
çekmeyen	çek
çekmeyi	çekme
çekmez	çek
çekmezlik	çek
çekmiş	çek
çekmişler	çek
çekmişlerdir	çek
çekmişti	çek
çekmiştim	çek
çekmiştir	çek
çekmiyor	çek
çekoslavakya	çekoslavakya
çekoslovakya	çekoslovakya
çeksin	çek
çekten	çek
çekti	çek
çektiği	çek
çektiğim	çek
çektiğimi	çek
çektiğimiz	çek
çektiğin	çek
çektiğinde	çek
çektiğini	çek
çektiğiniz	çek
çektiğinizde	çek
çektiği	çek
çektik	çek
çektikleri	çek
çektiklerini	çek
çektikten	çek
çektiler	çek
çektim	çek
çektiniz	çek
çektirdi	çek
çektirdiği	çek
çektirdiler	çek
çektirdim	çek
çektirerek	çek
çektirilen	çek
çektirir	çek
çektirme	çek
çektirmeden	çek
çektirmek	çek
çelebi	çelebi
çelebi'nin	çelebi
çelebi'ye	çelebi
çelebi'yi	çelebi
çelebiler	çelebi
çelebinin	çelebi
çelebioğlu	çelebioğlu
çelen	çel
çelenk	çelenk
çeliğe	çeliğ
çeliği	çeliğ
çeliğin	çeliğ
çelişen	çeliş
çelişik	çelişik
çelişir	çeliş
çelişiyor	çeliş
çelişki	çelişki
çelişkidir	çelişki
çelişkiler	çelişki
çelişkileri	çelişki
çelişkilerin	çelişki
çelişkilerini	çelişki
çelişkili	çelişki
çelişkilidir	çelişki
çelişkinin	çelişki
çelişkisi	çelişki
çelişkiye	çelişki
çelişkiyi	çelişki
çelişme	çeliş
çelişmektedir	çeliş
çelişmelerin	çeliş
çelik	çelik
çelik'e	çelik
çelik'i	çelik
çelik'in	çelik
çelikel	çelikel
çeliker	çeliker
çelikhan	çelikhan
çelikle	çelik
çelikler	çelik
çeliklerin	çelik
çelikten	çelik
çeliktepe	çeliktepe
çeliktir	çelik
çelimsiz	çelim
çelme	çel
çeltek	çeltek
çeltik	çeltik
çeltikte	çeltik
çem	çem
çember	çember
çemberi	çember
çemberin	çember
çemberine	çember
çemberini	çember
çemberler	çember
çemberleri	çember
çemberlerinin	çember
çene	çene
çenede	çene
çeneleri	çene
çenelerinde	çene
çeneli	çene
çenenin	çene
çenesi	çene
çenesini	çene
çeneye	çene
çeneyi	çene
çenğelköy'de	çenğelköy
çentiği	çentiğ
çentik	çentik
çepeçevre	çepeçevre
çeperi	çeper
çerçeve	çerçeve
çerçevede	çerçeve
çerçevedeki	çerçeve
çerçeveden	çerçeve
çerçevedir	çerçeve
çerçeveleme	çerçevele
çerçeveler	çerçeve
çerçevelerde	çerçeve
çerçevelere	çerçeve
çerçeveleri	çerçeve
çerçevelerin	çerçeve
çerçevelerine	çerçeve
çerçevelerinin	çerçeve
çerçeveli	çerçeve
çerçevenin	çerçeve
çerçevesi	çerçeve
çerçevesidir	çerçeve
çerçevesinde	çerçeve
çerçevesindedir	çerçeve
çerçevesindeki	çerçeve
çerçevesinden	çerçeve
çerçevesine	çerçeve
çerçevesini	çerçeve
çerçevesinin	çerçeve
çerçeveye	çerçeve
çerçeveyi	çerçeve
çerez	çerez
çerkeş	çerkeş
çerkes	çerkes
çerkesler	çerkes
çerkeslerin	çerkes
çerkez	çerkez
çerkezköy	çerkezköy
çerkezköy'de	çerkezköy
çermik	çermik
çernobil	çernobil
çernobil'in	çernobil
çesme	çesme
çesmesi	çesme
çesmesidir	çesme
çete	çet
çeteler	çete
çetelere	çete
çeteleri	çete
çetelerin	çete
çetelerinin	çete
çetenin	çete
çetesi	çete
çetesinin	çete
çeteye	çete
çetin	çetin
çetin'in	çetin
çetiner	çetiner
çetinkaya	çetinkaya
çetinkaya'nın	çetinkaya
çetintaş	çetintaş
çev	çev
çevik	çevik
çevik'in	çevik
çevir	çevir
çevirdi	çevir
çevirdiği	çevir
çevirdiğimiz	çevir
çevirdik	çevir
çevirdikten	çevir
çevirdiler	çevir
çevirdim	çevir
çevire	çevir
çevirebilir	çevir
çevirebilirim	çevir
çevirebilirsiniz	çevir
çevirebilme	çevir
çevirecek	çevir
çevirelim	çevir
çeviren	çevir
çevirenin	çevir
çevirenler	çevir
çevirerek	çevir
çeviri	çeviri
çevirici	çevir
çeviriciler	çevir
çeviricisi	çevir
çeviride	çeviri
çeviriler	çeviri
çevirileri	çeviri
çevirilerin	çeviri
çevirilerini	çeviri
çevirim	çeviri
çevirin	çevir
çevirince	çevir
çevirinin	çeviri
çeviriniz	çevir
çevirip	çevir
çevirir	çevir
çevirirken	çevir
çevirirler	çevir
çevirisi	çeviri
çevirisidir	çeviri
çevirisinde	çeviri
çevirisini	çeviri
çeviriye	çeviri
çeviriyi	çeviri
çeviriyor	çevir
çevirme	çevirme
çevirmeden	çevir
çevirmek	çevir
çevirmekle	çevir
çevirmektedir	çevir
çevirmeleri	çevirme
çevirmeli	çevir
çevirmen	çevirme
çevirmenin	çevirme
çevirmesi	çevirme
çevirmeye	çevir
çevirmeyi	çevirme
çevirmiş	çevir
çevirmişlerdir	çevir
çevirmişti	çevir
çevirmiştir	çevir
çevko	çevko
çevre	çevre
çevreci	çevre
çevreciler	çevre
çevrecilerin	çevre
çevrecilik	çevre
çevrede	çevre
çevredeki	çevre
çevreden	çevre
çevredir	çevre
çevrelediği	çevrele
çevrelenmiş	çevrele
çevrelenmiştir	çevrele
çevreler	çevre
çevrelerce	çevre
çevrelerde	çevre
çevrelerden	çevre
çevrelere	çevre
çevreleri	çevre
çevrelerin	çevre
çevrelerince	çevre
çevrelerinde	çevre
çevrelerindeki	çevre
çevrelerinden	çevre
çevrelerine	çevre
çevrelerini	çevre
çevrelerinin	çevre
çevreleriyle	çevre
çevreleyen	çevrele
çevrem	çevre
çevremde	çevre
çevremdeki	çevre
çevremdekilerin	çevre
çevreme	çevre
çevremi	çevre
çevremizde	çevre
çevremizdeki	çevre
çevremizden	çevre
çevremize	çevre
çevremizi	çevre
çevremizin	çevre
çevrene	çevre
çevrenin	çevre
çevreniz	çevre
çevrenizde	çevre
çevrenizdeki	çevre
çevrenizdekilere	çevre
çevrenizden	çevre
çevrenize	çevre
çevrenizi	çevre
çevrenizle	çevre
çevresel	çevre
çevresi	çevre
çevresidir	çevre
çevresinde	çevre
çevresindeki	çevre
çevresindekiler	çevre
çevresindekilere	çevre
çevresindekileri	çevre
çevresinden	çevre
çevresine	çevre
çevresini	çevre
çevresinin	çevre
çevresiyle	çevre
çevreye	çevre
çevreyi	çevre
çevreyle	çevre
çevrildi	çevr
çevrildiği	çevr
çevrilebilir	çevr
çevrilecek	çevr
çevrilecektir	çevr
çevrilemez	çevrile
çevrilen	çevr
çevrilerek	çevr
çevrili	çevril
çevrilidir	çevri
çevrilip	çevr
çevrilir	çevr
çevriliydi	çevril
çevriliyor	çevril
çevrilme	çevr
çevrilmek	çevr
çevrilmektedir	çevr
çevrilmelidir	çevr
çevrilmesi	çevr
çevrilmesinde	çevr
çevrilmesine	çevr
çevrilmesini	çevr
çevrilmiş	çevr
çevrilmiştir	çevr
çevrim	çevri
çevrimdışı	çevrimdış
çevrime	çevri
çevrimi	çevri
çevrimiçi	çevrimiçi
çevrimin	çevri
çevriminde	çevrim
çevrimini	çevrim
çevriminin	çevrim
çevrimleri	çevrim
çevrimlerin	çevrim
çevrimli	çevrimli
çeyiz	çeyiz
çeyizi	çeyiz
çeyizleri	çeyiz
çeyreği	çeyreğ
çeyreğinde	çeyreğ
çeyreğine	çeyreğ
çeyrek	çeyrek
çeyrekte	çeyrek
çhd	çhd
çhs'nin	çhs
çiçeğe	çiçeğ
çiçeği	çiçeğ
çiçeğin	çiçeğ
çiçeğini	çiçeğ
çiçeğinin	çiçeğ
çiçeği	çiçeğ
çiçeğim	çiçeğ
çiçek	çiçek
çiçek'in	çiçek
çiçekçi	çiçek
çiçekçiler	çiçek
çiçekçilik	çiçek
çiçekevi	çiçekev
çiçekle	çiçek
çiçeklenen	çiçekle
çiçeklenir	çiçekle
çiçeklenme	çiçekle
çiçeklenmeye	çiçekle
çiçekler	çiçek
çiçeklerden	çiçek
çiçeklere	çiçek
çiçekleri	çiçek
çiçeklerin	çiçek
çiçeklerine	çiçek
çiçeklerini	çiçek
çiçeklerinin	çiçek
çiçekleriyle	çiçek
çiçeklerle	çiçek
çiçekli	çiçekli
çiçekten	çiçek
çiğ	çiğ
çiğdem	çiğde
çiğit	çiğit
çiğli	çiğli
çiğneme	çiğne
çiğnemek	çiğne
çiğnemeye	çiğne
çiğnemiş	çiğne
çiğnenen	çiğnen
çiğnenir	çiğnen
çiğnenmesi	çiğnen
çiğneyerek	çiğne
çift	çift
çiftçi	çiftçi
çiftçidir	çiftçi
çiftçiler	çiftçi
çiftçilerden	çiftçi
çiftçilere	çiftçi
çiftçileri	çiftçi
çiftçilerimiz	çiftçi
çiftçilerimize	çiftçi
çiftçilerimizin	çiftçi
çiftçilerin	çiftçi
çiftçilerle	çiftçi
çiftçilik	çiftçi
çiftçilikle	çiftçi
çiftçimiz	çiftçi
çiftçimizin	çiftçi
çiftçinin	çiftçi
çiftçisi	çiftçi
çiftçisine	çiftçi
çiftçisinin	çiftçi
çiftçiye	çiftçi
çiftçiyi	çiftçi
çifte	çifte
çiftehavuzlar	çiftehavuzlar
çifter	çifter
çifti	çift
çiftin	çift
çiftinin	çift
çiftleşme	çiftleş
çiftler	çift
çiftlerde	çift
çiftlere	çift
çiftleri	çift
çiftlerin	çift
çiftli	çift
çiftliğe	çiftliğ
çiftliği	çiftliğ
çiftliği'nde	çiftliği
çiftliği'nin	çiftliği
çiftliğin	çiftliğ
çiftliğinde	çiftliğ
çiftliği	çiftliğ
çiftlik	çiftlik
çiftlikköy	çiftlikköy
çiftlikler	çiftlik
çiftliklerde	çiftlik
çiftlikleri	çiftlik
çiftliklerinde	çiftlik
çiftlikte	çiftlik
çiftte	çift
çifttir	çift
çiğ	çiğ
çiğdem	çiğde
çiğli	çiğli
çikan	çika
çikolata	çikolata
çikolatalı	çikolata
çikolatalar	çikolata
çikolatanın	çikolata
çil	çil
çile	çil
çileden	çile
çilek	çilek
çilekli	çilekli
çileler	çile
çileli	çile
çilesi	çile
çilesini	çile
çileyi	çile
çiller	çil
çiller'in	çiller
çim	çim
çimen	çim
çimenlik	çimenlik
çimentaş	çimentaş
çimentepe	çimentepe
çimento	çimento
çimentodan	çimento
çimentodur	çimento
çimentolar	çimento
çimentolu	çimento
çimentonun	çimento
çimentosu	çimento
çimentoyu	çimento
çimlendirilmiş	çimlen
çimlendirme	çimlen
çimlenen	çimlen
çimlenme	çimlen
çimlenmesi	çimlen
çimler	çim
çimleri	çim
çimlerin	çim
çimsa	çimsa
çin	çin
çin'de	çin
çin'deki	çin
çin'den	çin
çin'e	çin
çin'i	çin
çin'in	çin
çin'le	çin
çince	çince
çinde	çin
çine	çin
çini	çini
çinicilik	çini
çiniler	çini
çinileri	çini
çinilerle	çini
çinili	çini
çinko	çinko
çinkonun	çinko
çinli	çinli
çinli'ler	çinli
çinli'lerin	çinli
çinliler	çinli
çinlilerin	çinli
çip	çip
çipi	çip
çipini	çip
çipinin	çip
çiplerin	çip
çipli	çip
çipura	çipura
çirkin	çirkin
çirkindi	çirkin
çirkindir	çirkin
çirkini	çirkin
çirkinliği	çirkin
çirkinlik	çirkin
çirkinlikleri	çirkin
çit	çit
çitin	çit
çitle	çit
çivi	çivi
çivileme	çivile
çiviler	çivi
çivileri	çivi
çivili	çivili
çivisi	çivi
çivril	çivril
çiya	çiya
çiye	çiy
çiz	çiz
çizdi	çiz
çizdiği	çiz
çizdiğim	çiz
çizdiğimiz	çiz
çizdiğiniz	çiz
çizdik	çiz
çizdim	çiz
çizebilir	çiz
çizebilirsiniz	çiz
çizecek	çiz
çizelim	çiz
çizen	çiz
çizenler	çiz
çizer	çiz
çizerek	çiz
çizerin	çizer
çizerken	çiz
çizerler	çiz
çizici	çiz
çizik	çizik
çizildi	çiz
çizildiği	çiz
çizildikten	çiz
çizilebilir	çiz
çizilecek	çiz
çizilecektir	çiz
çizilen	çiz
çizilerek	çiz
çizili	çizi
çizilip	çiz
çizilir	çiz
çiziliyor	çiz
çizilmektedir	çiz
çizilmelidir	çiz
çizilmesi	çiz
çizilmeye	çiz
çizilmez	çiz
çizilmiş	çiz
çizilmiştir	çiz
çizim	çizi
çizimde	çizi
çizimdeki	çizi
çizimden	çizi
çizime	çizi
çizimi	çizi
çizimin	çizi
çizimine	çizim
çizimini	çizim
çiziminin	çizim
çizimle	çizi
çizimler	çizim
çizimlerde	çizim
çizimlerden	çizim
çizimlere	çizim
çizimleri	çizim
çizimlerin	çizim
çizimlerinde	çizim
çizimlerine	çizim
çizimlerini	çizim
çizimlerinin	çizim
çizimlerle	çizim
çizin	çiz
çiziniz	çiz
çizip	çiz
çiziyor	çiz
çiziyorlar	çiz
çiziyorum	çiz
çiziyoruz	çiz
çizme	çiz
çizmeci	çizme
çizmek	çiz
çizmekte	çiz
çizmektedir	çiz
çizmeler	çizme
çizmeleri	çizme
çizmeli	çiz
çizmeye	çiz
çizmeyi	çizme
çizmiş	çiz
çizmiştir	çiz
çoçuk	çoçuk
çoğalıp	çoğal
çoğalır	çoğal
çoğalırlar	çoğal
çoğalıyor	çoğal
çoğalıyordu	çoğal
çoğalan	çoğal
çoğalarak	çoğal
çoğaldı	çoğal
çoğaldığı	çoğal
çoğaldıkça	çoğal
çoğaldılar	çoğal
çoğalmış	çoğal
çoğalmıştır	çoğal
çoğalma	çoğal
çoğalmak	çoğal
çoğalmakta	çoğal
çoğalmaktadır	çoğal
çoğalmaları	çoğal
çoğalması	çoğal
çoğalmasını	çoğal
çoğalmasına	çoğal
çoğalmasıyla	çoğal
çoğalmaya	çoğal
çoğaltılıp	çoğal
çoğaltılır	çoğal
çoğaltılabilir	çoğal
çoğaltılamaz	çoğal
çoğaltılan	çoğal
çoğaltılarak	çoğal
çoğaltılmış	çoğal
çoğaltılması	çoğal
çoğaltıp	çoğal
çoğaltabilir	çoğal
çoğaltabiliriz	çoğal
çoğaltan	çoğal
çoğaltarak	çoğal
çoğaltma	çoğal
çoğaltmak	çoğal
çoğaltmaya	çoğal
çoğu	çoğu
çoğul	çoğul
çoğulcu	çoğulcu
çoğulculuğun	çoğulcu
çoğulculuk	çoğulcu
çoğumuz	çoğu
çoğumuzun	çoğu
çoğun	çoğun
çoğuna	çoğu
çoğunda	çoğu
çoğundan	çoğu
çoğunluğa	çoğunluğ
çoğunluğu	çoğunluğ
çoğunluğudur	çoğunluğ
çoğunluğun	çoğunluğ
çoğunluğuna	çoğunluğ
çoğunluğunda	çoğunluğ
çoğunluğunu	çoğunluğ
çoğunluğunun	çoğunluğ
çoğunluğuyla	çoğunluğ
çoğunluk	çoğunluk
çoğunlukla	çoğunlukla
çoğunlukta	çoğunluk
çoğunluktadır	çoğunluk
çoğunluktaydı	çoğunluk
çoğunu	çoğu
çoğunun	çoğu
çoğunuz	çoğu
çoğunuzun	çoğu
çoşkun	çoşkun
çoban	çoban
çobançeşme	çobançeşme
çobanın	çoban
çobana	çoban
çobanlık	çoban
çobanlar	çoban
çobanları	çoban
çobanların	çoban
çobanoğlu	çobanoğlu
çocuğa	çocuğ
çocuğu	çocuğ
çocuğudur	çocuğ
çocuğum	çocuğ
çocuğuma	çocuğ
çocuğumu	çocuğ
çocuğumun	çocuğ
çocuğumuz	çocuğ
çocuğumuzu	çocuğ
çocuğumuzun	çocuğ
çocuğun	çocuğ
çocuğuna	çocuğ
çocuğunda	çocuğ
çocuğundan	çocuğ
çocuğunu	çocuğ
çocuğunun	çocuğ
çocuğunuz	çocuğ
çocuğunuza	çocuğ
çocuğunuzda	çocuğ
çocuğunuzla	çocuğ
çocuğunuzu	çocuğ
çocuğunuzun	çocuğ
çocuğuyla	çocuğ
çocuğuyum	çocuğ
çocuğa	çocuğ
çocuğu	çocuğ
çocuğun	çocuğ
çocuğuna	çocuğ
çocuk	çocuk
çocuk'ta	çocuk
çocukça	çocukça
çocukken	çocuk
çocukla	çocuk
çocuklar	çocuk
çocukları	çocuk
çocuklarım	çocuk
çocuklarımı	çocuk
çocuklarımın	çocuk
çocuklarımız	çocuk
çocuklarımızı	çocuk
çocuklarımızın	çocuk
çocuklarımıza	çocuk
çocuklarımızdan	çocuk
çocuklarımızla	çocuk
çocuklarıma	çocuk
çocukların	çocuk
çocuklarını	çocuk
çocuklarının	çocuk
çocuklarınız	çocuk
çocuklarınızı	çocuk
çocuklarınızın	çocuk
çocuklarınıza	çocuk
çocuklarınızla	çocuk
çocuklarına	çocuk
çocuklarında	çocuk
çocuklarından	çocuk
çocuklarıyla	çocuk
çocuklara	çocuk
çocuklardır	çocuk
çocuklarda	çocuk
çocuklardaki	çocuk
çocuklardan	çocuk
çocuklarla	çocuk
çocuklu	çocuklu
çocukluğa	çocukluğ
çocukluğu	çocukluğ
çocukluğum	çocukluğ
çocukluğumda	çocukluğ
çocukluğumdan	çocukluğ
çocukluğumu	çocukluğ
çocukluğumun	çocukluğ
çocukluğumuzda	çocukluğ
çocukluğun	çocukluğ
çocukluğunda	çocukluğ
çocukluğundan	çocukluğ
çocukluğunu	çocukluğ
çocukluğunun	çocukluğ
çocukludur	çocuklu
çocukluk	çocukluk
çocuklukta	çocukluk
çocukluktan	çocukluk
çocuksu	çocuksu
çocuksuz	çocuk
çocukta	çocuk
çocuktaki	çocuk
çocuktan	çocuk
çocuktu	çocuk
çocuktum	çocuk
çocuktur	çocuk
çoğu	çoğu
çoğunda	çoğu
çoğunluğu	çoğunluğ
çoğunluğun	çoğunluğ
çoğunluğunu	çoğunluğ
çoğunluğunun	çoğunluğ
çoğunluk	çoğunluk
çoğunlukla	çoğunlukla
çoğunlukta	çoğunluk
çoğunu	çoğu
çoğunun	çoğu
çok	çok
çokça	çokça
çoker	çoker
çoklama	çokla
çokları	çokları
çoklu	çok
çokluğu	çokluğ
çokluğundan	çokluğ
çokluğunun	çokluğ
çokluğuyla	çokluğ
çokluğu	çokluğ
çokluk	çokluk
çoklukla	çoklukla
çokluortam	çokluortam
çoksa	çok
çoksesli	çoksesli
çokta	çok
çoktan	çok
çoktandır	çoktandır
çoktu	çok
çoktur	çok
çokuluslu	çokuluslu
çokum	çokum
çolak	çolak
çolakoğlu	çolakoğlu
çoluk	çoluk
çom	çom
çomak	çomak
çomaklı	çomaklı
çook	çook
çopur	çopur
çorabı	çorab
çorak	çorak
çorap	çorap
çoraplar	çorap
çorapları	çorap
çoraplarını	çorap
çorba	çorba
çorbada	çorba
çorbalar	çorba
çorbalara	çorba
çorbanın	çorba
çorbası	çorba
çorbasını	çorba
çorbaya	çorba
çorlu	çorlu
çorlu'da	çorlu
çoruh	çoruh
çorum	çor
çorum'a	çorum
çorum'da	çorum
çorum'un	çorum
çorumlu	çorumlu
çubuğa	çubuğ
çubuğu	çubuğ
çubuğun	çubuğ
çubuğuna	çubuğ
çubuğunda	çubuğ
çubuğundaki	çubuğ
çubuğundan	çubuğ
çubuğunu	çubuğ
çubuğunun	çubuğ
çubuk	çubuk
çubukçu	çubukçu
çubukla	çubuk
çubuklar	çubuk
çubukları	çubuk
çubukların	çubuk
çubuklarını	çubuk
çubuklarının	çubuk
çubuklarla	çubuk
çubuklu	çubuklu
çuha	çuha
çukulata	çukulata
çukur	çukur
çukurçeşme	çukurçeşme
çukura	çukur
çukurca	çukur
çukurda	çukur
çukurdan	çukur
çukurlar	çukur
çukurları	çukur
çukurların	çukur
çukurlara	çukur
çukurlarda	çukur
çukurova	çukurova
çukurova'da	çukurova
çukurova'yı	çukurova
çukurova'ya	çukurova
çukuru	çukur
çukurun	çukur
çukuruna	çukur
çukurunu	çukur
çukurunun	çukur
çul	çul
çulha	çulha
çullu	çullu
çumra	çumra
çuvaşça	çuvaşça
çuval	çuval
çuvaldızı	çuvaldız
çuvallar	çuval
çydd	çydd
ı	ı
ıçel'de	ıçel
ıçel'in	ıçel
ıı	ıı
ışığı	ışığ
ışığın	ışığ
ışığını	ışığ
ışığının	ışığ
ışığına	ışığ
ışığında	ışığ
ışığından	ışığ
ışığıyla	ışığ
ışığa	ışığ
ışık	ışık
ışıklı	ışıklı
ışıklık	ışık
ışıkla	ışık
ışıklandırılmış	ışıklan
ışıklandırılması	ışıklan
ışıklandırma	ışıklan
ışıklar	ışık
ışıkları	ışık
ışıkların	ışık
ışıklarını	ışık
ışıklarına	ışık
ışıklarında	ışık
ışıklarıyla	ışık
ışıklara	ışık
ışıklarla	ışık
ışıksız	ışık
ışıktır	ışık
ışıkta	ışık
ışıktan	ışık
ışıl	ışıl
ışıldayan	ışılda
ışıltı	ışıltı
ışıltılı	ışıltı
ışıltısı	ışıltı
ışıma	ışı
ışımanın	ışı
ışıması	ışı
ışın	ışın
ışını	ışın
ışınım	ışın
ışınımı	ışın
ışının	ışın
ışınlı	ışınlı
ışınlama	ışınla
ışınlanmalar	ışınla
ışınlar	ışın
ışınları	ışın
ışınların	ışın
ışınlarını	ışın
ışınlarının	ışın
ışınlarına	ışın
ışınlarından	ışın
ışınlarıyla	ışın
ışınlara	ışın
ışınlarla	ışın
ışınsal	ışın
ışkur'un	ışkur
ışlemleri'ndeki	ışlemleri
ışletmeleri'nin	ışletmeleri
ışletmesi'nde	ışletmesi
ışte	ışte
ışten	ışte
ıak'ın	ıak
ıbn	ıbn
ıbrahim	ıbrahim
ıbrahim'e	ıbrahim
ıbrahim'in	ıbrahim
ıbrahimi	ıbrahim
ıd	ıd
ıda	ı
ıdare	ıdare
ıdare'nin	ıdare
ıdarece	ıdare
ıdareci	ıdare
ıdarecilik	ıdare
ıdarede	ıdare
ıdareler	ıdare
ıdarelerce	ıdare
ıdareleri	ıdare
ıdarelerin	ıdare
ıdarelerince	ıdare
ıdarelerine	ıdare
ıdarelerinin	ıdare
ıdaremiz	ıdare
ıdarenin	ıdare
ıdaresi	ıdare
ıdaresi'ne	ıdaresi
ıdaresi'nin	ıdaresi
ıdaresince	ıdare
ıdaresinde	ıdare
ıdaresine	ıdare
ıdaresinin	ıdare
ıdareye	ıdare
ıdareyi	ıdare
ıdea	ıdea
ıdea'nın	ıdea
ıdealar	ıdea
ıdo'nun	ıdo
ıdris	ıdris
ıe	ıe
ıf	ıf
ıfa	ıf
ıfsak	ıf
ığdaş'ın	ığdaş
ıh	ıh
ıha	ıh
ıhlamur	ıhlamur
ıhsan	ıh
ıkıncı	ıkın
ıki	ıki
ıkiden	ıki
ıkili	ıki
ıkimiz	ıki
ıkinci	ıkinci
ıkinciliği	ıkinci
ıkincilik	ıkinci
ıkincisi	ıkinci
ıkincisinde	ıkinci
ıkindi	ıki
ıkisi	ıki
ıkisini	ıki
ıkisinin	ıki
ıklım	ıklım
ıl	ıl
ılçesi'nde	ılçesi
ılçesi'ne	ılçesi
ılçesi'nin	ılçesi
ılı	ıl
ılık	ılık
ılıman	ılıman
ılımlı	ılım
ılan	ılan
ılanı	ılan
ılanın	ılan
ılanda	ılan
ılanlar	ılan
ılanları	ılan
ılanların	ılan
ılesam'ın	ılesam
ıletişim'in	ıletişim
ılhan'ın	ılhan
ıli'nde	ıli
ıli'nin	ıli
ılk	ılk
ılkokulu'nda	ılkokulu
ılon	ılo
ılyada	ılya
ım	ı
ıma	ı
ıman	ıman
ımf	ımf
ımkb	ımkb
ımla	ı
ımparatorluğu'na	ımparatorluğu
ımparatorluğu'nda	ımparatorluğu
ımparatorluğu'nu	ımparatorluğu
ımparatorluğu'nun	ımparatorluğu
ımre	ımre
ımren	ımre
ın	ı
ını	ı
ının	ı
ınönü'nün	ınönü
ınönü'yü	ınönü
ınönü'ye	ınönü
ınşaat'ın	ınşaat
ına	ı
ınan'ın	ınan
ınc	ınc
ıncı	ınc
ınce'nin	ınce
ıncesu	ıncesu
ınci'nin	ınci
ıncil'de	ıncil
ında	ı
ından	ı
ındex	ındex
ınebolu'ya	ınebolu
ınfluenza	ınfluenza
ınğiliz'in	ınğiliz
ınğilizce'de	ınğilizce
ınğilizce'deki	ınğilizce
ınğilizce'den	ınğilizce
ınğilizce'dir	ınğilizce
ınğilizce'nin	ınğilizce
ınğilizce'ye	ınğilizce
ınğilizce'yi	ınğilizce
ınğilizler'in	ınğilizler
ınğiltere'de	ınğiltere
ınğiltere'deki	ınğiltere
ınğiltere'den	ınğiltere
ınğiltere'nin	ınğiltere
ınğiltere'ye	ınğiltere
ınğiltere'yi	ınğiltere
ınsan	ı
ınter	ınter
ınternal	ınternal
ınternational	ınternational
ınternet	ınternet
ınternet'e	ınternet
ınternet'i	ınternet
ınternet'in	ınternet
ınternet'te	ınternet
ınternet'teki	ınternet
ınternet'ten	ınternet
ınternete	ınternet
ınterneti	ınternet
ınternetin	ınternet
ınternetinin	ınternet
ınternetle	ınternet
ınternette	ınternet
ınternetteki	ınternet
ınternetten	ınternet
ıo'nun	ıo
ıp	ıp
ıpekçi'nin	ıpekçi
ırak	ırak
ıran	ıra
ıran'ı	ıran
ıran'ın	ıra
ıran'a	ıra
ıran'da	ıran
ıran'daki	ıran
ıran'dan	ıran
ıran'lı	ıran
ıran'la	ıran
ırat	ıra
ıris	ıris
ırk	ırk
ırkçı	ırk
ırkçılığı	ırk
ırkçılığın	ırk
ırkçılık	ırk
ırkı	ırk
ırkın	ırk
ırkını	ırk
ırkının	ırk
ırkına	ırk
ırkından	ırk
ırka	ırk
ırki	ırki
ırklar	ırk
ırkları	ırk
ırkların	ırk
ırklarının	ırk
ırklara	ırk
ırklardan	ırk
ırksal	ırk
ırktır	ırk
ırkta	ırk
ırktan	ırk
ırlanda	ırlanda
ırlanda'da	ırlanda
ırlanda'dan	ırlanda
ırlanda'nın	ırlanda
ırlanda'ya	ırlanda
ırlandalı	ırlanda
ırmağı	ırmağ
ırmağın	ırmağ
ırmağının	ırmağ
ırmağına	ırmağ
ırmağa	ırmağ
ırmak	ırmak
ırmaklar	ırmak
ırmakları	ırmak
ırmakların	ırmak
ırz	ırz
ırzına	ırz
ırza	ırz
ıs	ıs
ısı	ı
ısıcam	ısıcam
ısıda	ısı
ısıdan	ısı
ısıl	ısıl
ısılı	ısıl
ısıları	ısı
ısılarda	ısı
ısının	ı
ısınır	ısın
ısınıyor	ısın
ısınan	ısın
ısınmış	ısın
ısınma	ısın
ısınmada	ısın
ısınmadan	ısın
ısınmak	ısın
ısınmanın	ısın
ısınması	ısın
ısınmasını	ısın
ısınmasına	ısın
ısınmasıyla	ısın
ısınmaya	ısın
ısırığı	ısırığ
ısırık	ısırık
ısırılan	ısır
ısırılma	ısır
ısırma	ısır
ısısı	ısı
ısısını	ısı
ısısının	ısı
ısısına	ısı
ısısında	ısı
ısısından	ısı
ısısal	ısı
ısıtıcı	ısıt
ısıtıcılı	ısıt
ısıtıcılar	ısıt
ısıtıcıları	ısıt
ısıtıcıların	ısıt
ısıtıcısı	ısıt
ısıtılıp	ısıt
ısıtılır	ısıt
ısıtılan	ısıt
ısıtılarak	ısıt
ısıtıldığında	ısıt
ısıtılmış	ısıt
ısıtılmalı	ısıt
ısıtılması	ısıt
ısıtılmasında	ısıt
ısıtın	ısıt
ısıtıp	ısıt
ısıtır	ısıt
ısıtıyor	ısıt
ısıtan	ısıt
ısıtarak	ısıt
ısıtma	ısıt
ısıtmak	ısıt
ısıtmalı	ısıt
ısıtmaya	ısıt
ısıyı	ısı
ısıya	ısı
ısıyla	ı
ısa	ıs
ısa'dan	ısa
ısa'nın	ısa
ısa'ya	ısa
ıskan	ıska
ıskarta	ıskarta
ısken	ıs
ıskender'e	ıskender
ıskender'in	ıskender
ıskender'le	ıskender
ıskenderun'a	ıskenderun
ıskenderun'da	ıskenderun
ıskoçya'nın	ıskoçya
ıskonto	ıskonto
ıslık	ıslık
ıslah	ıslah
ıslahı	ıslah
ıslahına	ıslah
ıslahında	ıslah
ıslahat	ıslahat
ıslahatı	ıslahat
ıslahiye	ıslahiye
ıslak	ıslak
ıslakken	ıslak
ıslaklık	ıslak
ıslam	ıslam
ıslam'ı	ıslam
ıslam'ın	ıslam
ıslam'a	ıslam
ıslam'da	ıslam
ıslam'dan	ıslam
ıslamı	ıslam
ıslamın	ıslam
ıslama	ısla
ıslamcı	ıslam
ıslamcılık	ıslam
ıslamcılar	ıslam
ıslamcıların	ıslam
ıslamda	ıslam
ıslamiyet'i	ıslamiyet
ıslamiyet'in	ıslamiyet
ıslamiyet'te	ıslamiyet
ıslamiyet'ten	ıslamiyet
ıslamla	ıslam
ıslanır	ıslan
ıslanan	ıslan
ıslanmış	ıslan
ıslanma	ıslan
ıslanmak	ıslan
ıslatılarak	ısla
ıslatıp	ısla
ıslatan	ısla
ıslatma	ısla
ıslatmak	ısla
ısmail'in	ısmail
ısmarlama	ısmarla
ıso	ıso
ıspanak	ıspanak
ıspanya'da	ıspanya
ıspanya'daki	ıspanya
ıspanya'dan	ıspanya
ıspanya'nın	ıspanya
ıspanya'ya	ıspanya
ısrail'de	ısrail
ısrail'deki	ısrail
ısrail'den	ısrail
ısrail'e	ısrail
ısrail'i	ısrail
ısrail'in	ısrail
ısrail'le	ısrail
ısrar	ısrar
ısrarı	ısrar
ısrarına	ısrar
ısrarıyla	ısrar
ısrarcı	ısrar
ısrarlı	ısrar
ısrarla	ısrar
ısrarları	ısrar
ıssız	ıssız
ıstırap	ıstırap
ıstanbul	ıstanbul
ıstanbul'a	ıstanbul
ıstanbul'da	ıstanbul
ıstanbul'dadır	ıstanbul
ıstanbul'daki	ıstanbul
ıstanbul'dan	ıstanbul
ıstanbul'dur	ıstanbul
ıstanbul'la	ıstanbul
ıstanbul'lu	ıstanbul
ıstanbul'u	ıstanbul
ıstanbul'un	ıstanbul
ıstanbula	ıstanbul
ıstanbulda	ıstanbul
ıstanbuldaki	ıstanbul
ıstanbullu	ıstanbul
ıstanbullular	ıstanbul
ıstanbulluların	ıstanbul
ıstanbullulara	ıstanbul
ıstanbulu	ıstanbul
ıstanbulun	ıstanbul
ıste	ıste
ıstem	ıste
ıstemde	ıste
ısteme	ıste
ıstemi	ıste
ıster	ıster
ısterdim	ıster
ısterse	ıster
ıstersen	ıster
ısterseniz	ıster
ısveç'in	ısveç
ısveç'te	ısveç
ısveç'teki	ısveç
ısveç'ten	ısveç
ısviçre	ısviçre
ısviçre'de	ısviçre
ısviçre'deki	ısviçre
ısviçre'den	ısviçre
ısviçre'nin	ısviçre
ısviçre'ye	ısviçre
ısviçreli	ısviçre
ıt	ıt
ıtü'de	ıtü
ıtü'deki	ıtü
ıtü'den	ıtü
ıtü'nün	ıtü
ıta	ıt
ıtalya	ıtaly
ıtalya'da	ıtalya
ıtalya'daki	ıtalya
ıtalya'dan	ıtalya
ıtalya'nın	ıtalya
ıtalya'yı	ıtalya
ıtalya'ya	ıtalya
ıtalyan	ıtalya
ıtalyanca	ıtalya
ıtalyanlar	ıtalya
ıtalyanlar'ın	ıtalyanlar
ıv	ıv
ıvan	ıvan
ıvanov	ıvanov
ıyı	ı
ıyi	ıyi
ıyice	ıyi
ıyileşme	ıyi
ıyileştirilmesi	ıyi
ıyileştirme	ıyi
ıyiliği	ıyi
ıyilik	ıyi
ıyiyi	ıyi
ıyiyim	ıyi
ızaydaş'a	ızaydaş
ızdırabı	ızdırab
ızdırap	ızdırap
ızği'nin	ızği
ızmir'de	ızmir
ızmir'deki	ızmir
ızmir'den	ızmir
ızmir'e	ızmir
ızmir'i	ızmir
ızmir'in	ızmir
ızmir'li	ızmir
ızmit'e	ızmit
ızmit'in	ızmit
ızmit'te	ızmit
ızmit'teki	ızmit
ızmit'ten	ızmit
ıznik'te	ıznik
ö	ö
öç	öç
öçal	öçal
öğün	öğün
öğünde	öğün
öğünler	öğün
öğünlerde	öğün
öğürme	öğür
öğüt	öğüt
öğütülmüş	öğüt
öğütülmesi	öğüt
öğütler	öğüt
öğütleri	öğüt
öğütlerini	öğüt
öğütme	öğüt
öğe	öğe
öğe'yi	öğe
öğedir	öğe
öğeler	öğe
öğelerden	öğe
öğelere	öğe
öğeleri	öğe
öğeleridir	öğe
öğelerin	öğe
öğelerinden	öğe
öğelerine	öğe
öğelerini	öğe
öğelerinin	öğe
öğelerle	öğe
öğenin	öğe
öğesi	öğe
öğesidir	öğe
öğesine	öğe
öğesini	öğe
öğesinin	öğe
öğeye	öğe
öğeyi	öğe
öğle	öğle
öğleden	öğle
öğlen	öğle
öğlenden	öğle
öğlene	öğle
öğlenleri	öğlenleri
öğleye	öğle
öğleyin	öğleyin
öğren	öğren
öğrenci	öğrenci
öğrencide	öğrenci
öğrenciden	öğrenci
öğrencidir	öğrenci
öğrenciler	öğrenci
öğrencilerce	öğrenci
öğrencilerde	öğrenci
öğrencilerden	öğrenci
öğrencilerdir	öğrenci
öğrencilere	öğrenci
öğrencileri	öğrenci
öğrencilerim	öğrenci
öğrencilerime	öğrenci
öğrencilerimi	öğrenci
öğrencilerimin	öğrenci
öğrencilerimiz	öğrenci
öğrencilerimizden	öğrenci
öğrencilerimize	öğrenci
öğrencilerimizi	öğrenci
öğrencilerimizin	öğrenci
öğrencilerimizle	öğrenci
öğrencilerimle	öğrenci
öğrencilerin	öğrenci
öğrencilerinde	öğrenci
öğrencilerinden	öğrenci
öğrencilerine	öğrenci
öğrencilerini	öğrenci
öğrencilerinin	öğrenci
öğrencileriniz	öğrenci
öğrencilerinize	öğrenci
öğrencilerinizi	öğrenci
öğrencilerinizin	öğrenci
öğrencileriyle	öğrenci
öğrencilerle	öğrenci
öğrenciliğe	öğrenci
öğrenciliği	öğrenci
öğrencilik	öğrenci
öğrencilikten	öğrenci
öğrencim	öğrenci
öğrencimiz	öğrenci
öğrencimize	öğrenci
öğrencimizin	öğrenci
öğrencinin	öğrenci
öğrencisi	öğrenci
öğrencisidir	öğrenci
öğrencisinden	öğrenci
öğrencisine	öğrenci
öğrencisini	öğrenci
öğrencisinin	öğrenci
öğrencisiyim	öğrenci
öğrencisiyken	öğrenci
öğrencisiyle	öğrenci
öğrenciydi	öğrenci
öğrenciydim	öğrenci
öğrenciye	öğrenci
öğrenciyi	öğrenci
öğrenciyken	öğrenci
öğrenciyle	öğrenci
öğrendi	öğren
öğrendiği	öğren
öğrendiğim	öğren
öğrendiğime	öğren
öğrendiğimiz	öğren
öğrendiğimize	öğren
öğrendiğinde	öğren
öğrendiğine	öğren
öğrendiğini	öğren
öğrendiğiniz	öğren
öğrendik	öğren
öğrendikçe	öğren
öğrendikleri	öğrendik
öğrendiklerimizi	öğrendik
öğrendiklerimizin	öğrendik
öğrendiklerinde	öğrendik
öğrendiklerini	öğrendik
öğrendiklerinizi	öğrendik
öğrendikten	öğrendik
öğrendiler	öğren
öğrendim	öğren
öğrendin	öğren
öğrendiniz	öğren
öğrenebileceği	öğren
öğrenebileceğiniz	öğren
öğrenebilecek	öğren
öğrenebilir	öğren
öğrenebilirim	öğren
öğrenebiliriz	öğren
öğrenebilirler	öğren
öğrenebilirsiniz	öğren
öğrenebiliyor	öğren
öğrenebiliyorlar	öğren
öğrenebilme	öğren
öğrenebilmek	öğren
öğrenebilmesi	öğren
öğreneceği	öğren
öğreneceğini	öğren
öğreneceğiz	öğren
öğrenecek	öğren
öğrenecekler	öğren
öğreneceklerdir	öğren
öğrenecekleri	öğren
öğreneceksiniz	öğren
öğrenecektir	öğren
öğrenelim	öğren
öğrenemedik	öğren
öğrenememiş	öğren
öğrenemez	öğren
öğrenen	öğren
öğrenenler	öğren
öğrenerek	öğren
öğrenici	öğren
öğrenildi	öğren
öğrenildiği	öğren
öğrenilebilir	öğren
öğrenilecek	öğren
öğrenilemeyen	öğren
öğrenilen	öğren
öğrenilenler	öğren
öğrenilenlerin	öğren
öğrenilir	öğren
öğreniliyor	öğren
öğrenilmelidir	öğren
öğrenilmesi	öğren
öğrenilmesinde	öğren
öğrenilmesinden	öğren
öğrenilmesine	öğren
öğrenilmesini	öğren
öğrenilmiş	öğren
öğrenilmiştir	öğren
öğrenim	öğrenim
öğrenimde	öğrenim
öğrenime	öğrenim
öğrenimi	öğrenim
öğrenimime	öğrenim
öğrenimimi	öğrenim
öğrenimin	öğrenim
öğreniminde	öğrenim
öğreniminden	öğrenim
öğrenimine	öğrenim
öğrenimini	öğrenim
öğreniminin	öğrenim
öğrenimleri	öğrenim
öğrenimlerine	öğrenim
öğrenimlerini	öğrenim
öğrenimlerinin	öğrenim
öğrenin	öğren
öğrenince	öğren
öğreninceye	öğren
öğreniniz	öğren
öğrenip	öğren
öğrenir	öğren
öğrenirim	öğren
öğreniriz	öğren
öğrenirken	öğren
öğrenirler	öğren
öğrenirsiniz	öğren
öğreniyor	öğren
öğreniyorlar	öğren
öğreniyorum	öğren
öğreniyoruz	öğren
öğrenme	öğren
öğrenmede	öğren
öğrenmeden	öğren
öğrenmediğini	öğren
öğrenmedir	öğren
öğrenmek	öğren
öğrenmekle	öğren
öğrenmekte	öğren
öğrenmektedir	öğren
öğrenmekten	öğren
öğrenmekteyiz	öğren
öğrenmektir	öğren
öğrenmeler	öğren
öğrenmeleri	öğren
öğrenmelerin	öğren
öğrenmelerini	öğren
öğrenmeli	öğren
öğrenmelidir	öğren
öğrenmelisiniz	öğren
öğrenmeliyiz	öğren
öğrenmem	öğren
öğrenmeme	öğren
öğrenmemiz	öğren
öğrenmenin	öğren
öğrenmeniz	öğren
öğrenmenize	öğren
öğrenmenizi	öğren
öğrenmesi	öğren
öğrenmesine	öğren
öğrenmesini	öğren
öğrenmeye	öğren
öğrenmeyi	öğren
öğrenmiş	öğren
öğrenmişlerdi	öğren
öğrenmişlerdir	öğren
öğrenmişti	öğren
öğrenmiştim	öğren
öğrenmiştir	öğren
öğrensin	öğren
öğrensinler	öğren
öğret	öğret
öğretebilir	öğret
öğretecek	öğret
öğretelim	öğret
öğreten	öğret
öğreterek	öğret
öğreti	öğreti
öğretici	öğret
öğreticiler	öğret
öğretide	öğreti
öğretildi	öğret
öğretildiği	öğret
öğretilebilir	öğret
öğretilecek	öğret
öğretilecektir	öğret
öğretilemez	öğret
öğretilen	öğret
öğretiler	öğreti
öğretileri	öğreti
öğretilir	öğret
öğretiliyor	öğret
öğretilmekte	öğret
öğretilmektedir	öğret
öğretilmelidir	öğret
öğretilmesi	öğret
öğretim	öğreti
öğretimde	öğreti
öğretimdeki	öğreti
öğretimden	öğreti
öğretime	öğreti
öğretimi	öğreti
öğretimin	öğreti
öğretiminde	öğretim
öğretiminden	öğretim
öğretimine	öğretim
öğretimini	öğretim
öğretiminin	öğretim
öğretimle	öğreti
öğretimsel	öğretim
öğretin	öğret
öğretinin	öğreti
öğretiniz	öğret
öğretir	öğret
öğretirken	öğret
öğretisi	öğreti
öğretisine	öğreti
öğretiyor	öğret
öğretme	öğret
öğretmek	öğret
öğretmekle	öğret
öğretmektir	öğret
öğretmeleri	öğret
öğretmeliyiz	öğret
öğretmen	öğretmen
öğretmende	öğretmen
öğretmenden	öğretmen
öğretmendi	öğretmen
öğretmendir	öğretmen
öğretmene	öğretmen
öğretmenevi	öğretmenev
öğretmeni	öğretmen
öğretmenim	öğretmen
öğretmenimin	öğretmen
öğretmenimiz	öğretmen
öğretmenimizi	öğretmen
öğretmenimizin	öğretmen
öğretmenin	öğretmen
öğretmenine	öğretmen
öğretmenini	öğretmen
öğretmeninin	öğretmen
öğretmeninize	öğretmen
öğretmeninizin	öğretmen
öğretmeniyle	öğretmen
öğretmenle	öğretmen
öğretmenler	öğretmen
öğretmenlerce	öğretmen
öğretmenlerde	öğretmen
öğretmenlerden	öğretmen
öğretmenlerdir	öğretmen
öğretmenlere	öğretmen
öğretmenleri	öğretmen
öğretmenlerim	öğretmen
öğretmenlerimiz	öğretmen
öğretmenlerimizden	öğretmen
öğretmenlerimize	öğretmen
öğretmenlerimizi	öğretmen
öğretmenlerimizin	öğretmen
öğretmenlerimizle	öğretmen
öğretmenlerin	öğretmen
öğretmenlerince	öğretmen
öğretmenlerinden	öğretmen
öğretmenlerine	öğretmen
öğretmenlerini	öğretmen
öğretmenlerinin	öğretmen
öğretmenleriniz	öğretmen
öğretmenleriyle	öğretmen
öğretmenlerle	öğretmen
öğretmenliğe	öğretmen
öğretmenliği	öğretmen
öğretmenliğine	öğretmen
öğretmenliğinin	öğretmen
öğretmenlik	öğretmen
öğretmenlikten	öğretmen
öğretmeye	öğret
öğretmeyi	öğret
öğretmiş	öğret
öğretmişti	öğret
öğretmiştir	öğret
öğretti	öğret
öğrettiği	öğret
öğrettikleri	öğret
öbür	öbür
öbürü	öbürü
öbürünün	öbürü
öbürüne	öbürü
öbürleri	öbür
öbeğe	öbeğ
öbeği	öbeğ
öbek	öbek
öbekler	öbek
öbekleri	öbek
öcü	öc
öcünü	öc
öcal	öcal
öcalan	öcalan
öcalan'ı	öcalan
öcalan'ın	öcalan
öcalan'a	öcalan
ödül	ödül
ödülü	ödül
ödülü'nü	ödülü
ödülü'nün	ödülü
ödülü'ne	ödülü
ödülün	ödül
ödülünü	ödül
ödülünün	ödül
ödülüne	ödül
ödüle	ödül
ödüllü	ödül
ödülle	ödül
ödüllendirdi	ödüllendir
ödüllendirildi	ödüllendir
ödüllendirilecektir	ödüllendir
ödüllendirilen	ödüllendir
ödüllendirilir	ödüllendir
ödüllendiriliyor	ödüllendir
ödüllendirilmelidir	ödüllendir
ödüllendirilmesi	ödüllendir
ödüllendirilmiştir	ödüllendir
ödüllendirin	ödüllendir
ödüllendirme	ödüllendir
ödüllendirmek	ödüllendir
ödüller	ödül
ödüllere	ödül
ödülleri	ödül
ödüllerin	ödül
ödüllerine	ödül
ödüllerini	ödül
ödüllerinin	ödül
ödüllerle	ödül
ödün	öd
ödünç	ödünç
ödünler	ödün
ödünsüz	öd
ödüyor	öd
ödüyorlar	öd
ödüyorsunuz	öd
ödüyorum	öd
ödüyoruz	öd
öde	ö
ödedi	öde
ödediği	öde
ödediğimiz	öde
ödediğini	öde
ödediğiniz	öde
ödedik	öde
ödedikleri	öde
ödedikten	öde
ödediler	öde
ödedim	öde
ödem	ödem
ödeme	öde
ödemede	öde
ödemeden	öde
ödemediği	öde
ödemediğini	öde
ödemek	öde
ödemekle	öde
ödemeksizin	öde
ödemekte	öde
ödemektedir	öde
ödemektedirler	öde
ödemekten	öde
ödemeler	öde
ödemelerde	öde
ödemelerdeki	öde
ödemelerden	öde
ödemelere	öde
ödemeleri	öde
ödemelerin	öde
ödemelerinde	öde
ödemelerinden	öde
ödemelerine	öde
ödemelerini	öde
ödemelerinin	öde
ödemeleriniz	öde
ödemelerinizde	öde
ödemelerinizi	öde
ödemelerinizin	öde
ödemeleriyle	öde
ödemelerle	öde
ödemeli	öde
ödemelidir	öde
ödemem	öde
ödememe	öde
ödememek	öde
ödememesi	öde
ödememiş	öde
ödemenin	öde
ödemeniz	öde
ödemenize	öde
ödemenizi	öde
ödemesi	öde
ödemesinde	öde
ödemesinden	öde
ödemesine	öde
ödemesini	öde
ödemesinin	öde
ödemesiz	öde
ödemeye	öde
ödemeyeceksiniz	öde
ödemeyen	öde
ödemeyenler	öde
ödemeyenlerden	öde
ödemeyenlerin	öde
ödemeyi	öde
ödemez	öde
ödemezler	öde
ödemezsiniz	öde
ödemi	ödem
ödemiş	öde
ödemiştir	öde
ödemin	ödem
ödemine	ödem
ödemiyor	öde
ödemli	ödem
ödendi	öden
ödendiği	öden
ödendiğini	öden
ödendikten	öden
ödeneğe	ödeneğ
ödeneği	ödeneğ
ödeneğin	ödeneğ
ödeneğinden	ödeneğ
ödeneğine	ödeneğ
ödeneğinin	ödeneğ
ödenebilecek	öden
ödenebilir	öden
ödenebiliyor	öden
ödenebilmesi	öden
ödeneceği	öden
ödeneceğine	öden
ödeneceğini	öden
ödenecek	öden
ödenecektir	öden
ödeneği	ödeneğ
ödeneğin	ödeneğ
ödenek	ödenek
ödenekle	ödenek
ödenekler	ödenek
ödeneklerden	ödenek
ödenekleri	ödenek
ödeneklerin	ödenek
ödeneklerinden	ödenek
ödeneklerinin	ödenek
ödeneklerle	ödenek
ödeneksiz	ödenek
ödenekten	ödenek
ödenemez	öden
ödenen	öden
ödenerek	öden
ödenip	öden
ödenir	öden
ödeniyor	öden
ödenme	öden
ödenmeden	öden
ödenmediği	öden
ödenmedikçe	öden
ödenmek	öden
ödenmekte	öden
ödenmektedir	öden
ödenmelidir	öden
ödenmeme	öden
ödenmemektedir	öden
ödenmemesi	öden
ödenmemiş	öden
ödenmemişse	öden
ödenmesi	öden
ödenmesinde	öden
ödenmesinden	öden
ödenmesine	öden
ödenmesini	öden
ödenmesinin	öden
ödenmeye	öden
ödenmeyecek	öden
ödenmeyecektir	öden
ödenmeyen	öden
ödenmez	öden
ödenmezse	öden
ödenmiş	öden
ödenmiştir	öden
ödenmiyor	öden
ödenti	ödenti
ödentiler	ödenti
ödentileri	ödenti
ödentilerini	ödenti
ödentisi	ödenti
ödentisini	ödenti
ödentisinin	ödenti
öder	öde
öderim	öde
öderiz	öde
öderken	öde
öderler	öde
öderse	öde
ödersiniz	öde
ödesin	öde
ödev	ödev
ödevde	ödev
ödevi	ödev
ödevidir	ödev
ödevimi	ödev
ödevin	ödev
ödevini	ödev
ödevinizi	ödev
ödevler	ödev
ödevleri	ödev
ödevlerin	ödev
ödevlerine	ödev
ödevlerini	ödev
ödevlerinin	ödev
ödeyebilecekler	öde
ödeyebilir	öde
ödeyebilirim	öde
ödeyebilirler	öde
ödeyebilirsiniz	öde
ödeyeceği	öde
ödeyeceğim	öde
ödeyeceğini	öde
ödeyeceğiniz	öde
ödeyeceğiz	öde
ödeyecek	öde
ödeyecekler	öde
ödeyeceklerdir	öde
ödeyecekleri	öde
ödeyeceksiniz	öde
ödeyecektir	öde
ödeyemediği	öde
ödeyemeyecek	öde
ödeyemeyen	öde
ödeyemez	öde
ödeyemiyor	öde
ödeyen	öde
ödeyenler	öde
ödeyerek	öde
ödeyin	öde
ödeyip	öde
ödp	ödp
öf	öf
öfke	öfke
öfkeden	öfke
öfkelerini	öfke
öfkeli	öfke
öfkemi	öfke
öfkenin	öfke
öfkenizin	öfke
öfkesi	öfke
öfkesinden	öfke
öfkesini	öfke
öfkeye	öfke
öfkeyi	öfke
öfkeyle	öfke
öğütülür	öğüt
öğütüldükten	öğüt
öğütülerek	öğüt
öğütülmesi	öğüt
öğütme	öğüt
öğe	öğe
öğeler	öğe
öğelere	öğe
öğeleri	öğe
öğelerin	öğe
öğelerinden	öğe
öğelerinin	öğe
öğesi	öğe
öğesidir	öğe
öğesinin	öğe
öğle	öğle
öğleden	öğle
öğlen	öğle
öğrenci	öğrenci
öğrenciler	öğrenci
öğrencilerden	öğrenci
öğrencilere	öğrenci
öğrencileri	öğrenci
öğrencilerimiz	öğrenci
öğrencilerimize	öğrenci
öğrencilerimizin	öğrenci
öğrencilerin	öğrenci
öğrencilerinden	öğrenci
öğrencilerine	öğrenci
öğrencilerini	öğrenci
öğrencilerinin	öğrenci
öğrencilerle	öğrenci
öğrencilik	öğrenci
öğrencinin	öğrenci
öğrencisi	öğrenci
öğrenciye	öğrenci
öğrenciyi	öğrenci
öğrendik	öğren
öğrendim	öğren
öğrenebilirsiniz	öğren
öğrenen	öğren
öğrenilmesi	öğren
öğrenim	öğrenim
öğrenime	öğrenim
öğrenimi	öğrenim
öğrenimine	öğrenim
öğrenimini	öğrenim
öğrenin	öğren
öğrenir	öğren
öğrenirler	öğren
öğrenme	öğren
öğrenmek	öğren
öğrenmeleri	öğren
öğrenmeye	öğren
öğrenmeyi	öğren
öğretim	öğreti
öğretimde	öğreti
öğretime	öğreti
öğretimi	öğreti
öğretimin	öğreti
öğretiminde	öğretim
öğretimsel	öğretim
öğretir	öğret
öğretme	öğret
öğretmek	öğret
öğretmen	öğretmen
öğretmeni	öğretmen
öğretmenim	öğretmen
öğretmenin	öğretmen
öğretmenler	öğretmen
öğretmenlere	öğretmen
öğretmenleri	öğretmen
öğretmenlerin	öğretmen
öğretmenlerine	öğretmen
öğretmenliği	öğretmen
öğretmenlik	öğretmen
öğretti	öğret
öküz	öküz
öküzün	öküz
öküze	öküz
öküzleri	öküz
öke	ök
ökkeş	ökkeş
ökmen	ökmen
ökmen'e	ökmen
öksürüğü	öksürüğ
öksürüğün	öksürüğ
öksürüğe	öksürüğ
öksürük	öksürük
öksürükle	öksürük
öksürme	öksür
öksüz	öksüz
ökte	ök
öktem	öktem
ökten	ök
öl	öl
ölç	ölç
ölçü	ölçü
ölçüdür	ölçü
ölçüde	ölçü
ölçüdedir	ölçü
ölçüdeki	ölçü
ölçüden	ölçü
ölçülü	ölçülü
ölçülülük	ölçülü
ölçülür	ölç
ölçülüyor	ölç
ölçüldü	ölç
ölçüldüğü	ölç
ölçülebilen	ölç
ölçülebilir	ölç
ölçülebilmektedir	ölç
ölçülecek	ölç
ölçülecektir	ölç
ölçülemeyen	ölç
ölçülemez	ölç
ölçülen	ölç
ölçülendirme	ölçü
ölçüler	ölçü
ölçülerde	ölçü
ölçülerdeki	ölçü
ölçülere	ölçü
ölçülerek	ölç
ölçüleri	ölçü
ölçülerin	ölçü
ölçülerinde	ölçü
ölçülerinden	ölçü
ölçülerine	ölçü
ölçülerini	ölçü
ölçülerinin	ölçü
ölçüleriyle	ölçü
ölçülerle	ölçü
ölçülmüş	ölç
ölçülmüştür	ölç
ölçülmekte	ölç
ölçülmektedir	ölç
ölçülmeli	ölç
ölçülmelidir	ölç
ölçülmesi	ölç
ölçülmesidir	ölç
ölçülmesinde	ölç
ölçülmesine	ölç
ölçülmesini	ölç
ölçüm	ölçü
ölçümü	ölçü
ölçümüdür	ölçüm
ölçümün	ölçü
ölçümünü	ölçüm
ölçümünün	ölçüm
ölçümünde	ölçüm
ölçümde	ölçü
ölçüme	ölçü
ölçümle	ölçü
ölçümleme	ölçümle
ölçümlenebilir	ölçümle
ölçümler	ölçüm
ölçümlerde	ölçüm
ölçümlerden	ölçüm
ölçümlerdir	ölçümle
ölçümlere	ölçüm
ölçümleri	ölçüm
ölçümlerin	ölçüm
ölçümlerinde	ölçüm
ölçümlerinden	ölçüm
ölçümlerine	ölçüm
ölçümlerini	ölçüm
ölçümlerinin	ölçüm
ölçümlerle	ölçüm
ölçün	ölçün
ölçüp	ölç
ölçüsü	ölçü
ölçüsüdür	ölçü
ölçüsünü	ölçü
ölçüsünün	ölçü
ölçüsünde	ölçü
ölçüsüne	ölçü
ölçüsüyle	ölçü
ölçüsüz	ölçü
ölçüt	ölçüt
ölçütü	ölçüt
ölçütüdür	ölçüt
ölçütüne	ölçüt
ölçüte	ölçüt
ölçütler	ölçüt
ölçütlerden	ölçüt
ölçütlere	ölçüt
ölçütleri	ölçüt
ölçütlerin	ölçüt
ölçütlerine	ölçüt
ölçütlerini	ölçüt
ölçütlerinin	ölçüt
ölçüttür	ölçüt
ölçüyü	ölçü
ölçüye	ölçü
ölçüyor	ölç
ölçeğe	ölçeğ
ölçeği	ölçeğ
ölçeğin	ölçeğ
ölçeğinde	ölçeğ
ölçeğindeki	ölçeğ
ölçeğinden	ölçeğ
ölçeğine	ölçeğ
ölçeğini	ölçeğ
ölçeğinin	ölçeğ
ölçebilir	ölç
ölçecek	ölç
ölçeğinde	ölçeğ
ölçek	ölçek
ölçekle	ölçek
ölçekleme	ölçekle
ölçeklendirme	ölçek
ölçeklenebilir	ölçek
ölçeklenebilirlik	ölçek
ölçekler	ölçek
ölçeklerde	ölçek
ölçekleri	ölçek
ölçeklerinde	ölçek
ölçeklerinin	ölçek
ölçekli	ölçekli
ölçekte	ölçek
ölçekteki	ölçek
ölçekten	ölçek
ölçen	ölç
ölçer	ölç
ölçerek	ölç
ölçerken	ölç
ölçerler	ölç
ölçme	ölç
ölçmede	ölç
ölçmek	ölç
ölçmektedir	ölç
ölçmeler	ölç
ölçmelerde	ölç
ölçmeleri	ölç
ölçmenin	ölç
ölçmeye	ölç
ölçmeyi	ölç
ölü	ölü
ölüdeniz	ölüdeniz
ölüler	ölü
ölülere	ölü
ölüleri	ölü
ölülerin	ölü
ölülerini	ölü
ölüm	ölüm
ölümü	ölü
ölümün	ölü
ölümünü	ölüm
ölümünün	ölüm
ölümünde	ölüm
ölümünden	ölüm
ölümüne	ölümüne
ölümüyle	ölüm
ölümcül	ölümcül
ölümdür	ölü
ölümden	ölü
ölüme	ölü
ölümlü	ölüm
ölümlülük	ölüm
ölümle	ölü
ölümler	ölüm
ölümlerde	ölüm
ölümlerden	ölüm
ölümlere	ölüm
ölümleri	ölüm
ölümlerin	ölüm
ölümlerinde	ölüm
ölümlerinden	ölüm
ölümlerine	ölüm
ölümlerini	ölüm
ölümlerinin	ölüm
ölümsüz	ölüm
ölümsüzlük	ölüm
ölünün	ölü
ölünce	öl
ölünceye	öl
ölüp	öl
ölür	öl
ölürüm	öl
ölürken	öl
ölürler	öl
ölürse	öl
ölürsem	öl
ölüsü	ölü
ölüyü	ölü
ölüyor	öl
ölüyordu	öl
ölüyorlar	öl
ölüyorum	öl
öldü	öl
öldüğü	öl
öldüğünü	öl
öldüğünde	öl
öldüğüne	öl
öldüğü	öl
öldük	öl
öldükleri	öl
öldükten	öl
öldüler	öl
öldüm	öl
öldürücü	öldür
öldürücüdür	öldür
öldürülür	öldür
öldürülüyor	öldür
öldürüldü	öldür
öldürüldüğü	öldür
öldürüldüğünü	öldür
öldürüldükleri	öldür
öldürüldüler	öldür
öldürülen	öldür
öldürülenlerin	öldür
öldürülmüş	öldür
öldürülmüşlerdir	öldür
öldürülmüştü	öldür
öldürülmüştür	öldür
öldürülme	öldür
öldürülmesi	öldür
öldürülmesinden	öldür
öldürülmesine	öldür
öldürülmesini	öldür
öldürün	öldür
öldürüp	öldür
öldürür	öldür
öldürürler	öldür
öldürürse	öldür
öldürüyor	öldür
öldürüyorlar	öldür
öldürdü	öldür
öldürdüğü	öldür
öldürdüğünü	öldür
öldürdükleri	öldür
öldürdükten	öldür
öldürdüler	öldür
öldürdüm	öldür
öldürdünüz	öldür
öldürebilir	öldür
öldürecek	öldür
öldüren	öldür
öldürerek	öldür
öldüresiye	öldüresiye
öldürmüş	öldür
öldürmüşlerdir	öldür
öldürmüştür	öldür
öldürme	öldür
öldürmek	öldür
öldürmekle	öldür
öldürmektedir	öldür
öldürmekten	öldür
öldürmenin	öldür
öldürmesi	öldür
öldürmeye	öldür
öldürmeyi	öldür
öldürttü	öldür
ölebilir	öl
öleceği	öl
öleceğim	öl
öleceğine	öl
öleceğini	öl
öleceğiz	öl
ölecek	öl
öleceksin	öl
ölecektir	öl
öleli	öl
ölen	öl
ölene	öl
ölenin	öl
ölenler	öl
ölenlerden	öl
ölenlere	öl
ölenleri	öl
ölenlerin	öl
ölesiye	ölesiye
ölmüş	öl
ölmüşse	öl
ölmüştü	öl
ölmüştür	öl
ölmüyor	öl
ölme	öl
ölmeden	öl
ölmedi	öl
ölmek	öl
ölmekte	öl
ölmektedir	öl
ölmektedirler	öl
ölmekten	öl
ölmemek	öl
ölmemesi	öl
ölmesi	öl
ölmesin	öl
ölmesine	öl
ölmesini	öl
ölmesiyle	öl
ölmeye	öl
ölmeyecek	öl
ölmeyen	öl
ölmeyi	öl
ölmez	ölmez
ölmezler	öl
ölsün	öl
ölse	öl
ömür	ömür
ömürlü	ömürlü
ömürlüdür	ömür
ömürler	ömür
ömürleri	ömür
ömürlerini	ömür
ömürlerinin	ömür
ömer	ömer
ömer'in	ömer
ömerağa	ömerağa
ömerli	ömerli
ömeroğlu	ömeroğlu
ömrü	ömr
ömrüm	ömr
ömrümün	ömr
ömrümüz	ömr
ömrümüzün	ömr
ömrün	ömr
ömrünü	ömr
ömrünün	ömr
ömründe	ömr
ömrüne	ömr
ömre	ömr
ön	ön
önşart	önşart
önü	ö
önümüz	ön
önümüzü	ön
önümüzde	ön
önümüzdeki	ön
önümüze	ön
önümde	ön
önümdeki	ön
önümden	ön
önüme	ön
önünü	ön
önünün	ön
önünüzde	ön
önünüzdeki	ön
önünüze	ön
önünde	ön
önündedir	ön
önündeki	ön
önünden	önünden
önüne	ön
önür	önür
önal	önal
önalan	önalan
önayak	önayak
önbelleği	önbelleğ
önbellek	önbellek
öncü	öncü
öncüdür	öncü
öncül	öncül
öncülüğü	öncü
öncülüğünü	öncü
öncülüğünde	öncü
öncülüğündeki	öncü
öncülüğünde	öncü
öncülük	öncü
öncüler	öncü
öncüleri	öncü
öncülerinden	öncü
öncünün	öncü
öncüsü	öncü
öncüsüdür	öncü
önce	önce
öncede	önce
önceden	önceden
öncedir	ön
önceki	önceki
öncekiler	önceki
öncekilerden	önceki
öncekilere	önceki
öncekilerin	önceki
öncekinden	önceki
öncekine	önceki
öncekini	önceki
öncekinin	önceki
öncel	öncel
öncelere	önce
önceleri	önceleri
önceleyen	öncele
önceliğe	önceliğ
önceliği	önceliğ
önceliğimiz	önceliğ
önceliğin	önceliğ
önceliğine	önceliğ
önceliğini	önceliğ
önceliğinin	önceliğ
öncelik	öncelik
öncelikle	öncelikle
önceliklendirme	öncelik
öncelikler	öncelik
önceliklere	öncelik
öncelikleri	öncelik
önceliklerimizi	öncelik
önceliklerin	öncelik
önceliklerinden	öncelik
önceliklerine	öncelik
önceliklerini	öncelik
önceliklerinin	öncelik
öncelikli	öncelik
önceliklidir	öncelik
önceliktir	önce
öncellikle	öncel
öncesi	önce
öncesinde	önce
öncesindeki	önce
öncesinden	önce
öncesine	önce
öncesini	önce
öncesinin	önce
önceydi	ön
önceye	önce
öndül	öndül
önde	ö
öndedir	ö
öndeki	ö
öndekiler	ö
önden	ö
önder	önder
önder'in	önder
önderi	önder
önderimiz	önder
önderin	önder
önderler	önder
önderleri	önder
önderlerinden	önder
önderlerine	önder
önderlerinin	önder
önderliği	önder
önderliğinde	önder
önderliğindeki	önder
önderliğinde	önder
önderlik	önder
öne	ö
önek	önek
önekleri	önek
öneli	önel
önelini	önel
önem	önem
önemde	önem
önemdedir	önem
önemdeki	önem
önemden	önem
önemdir	önem
öneme	öne
önemi	önem
önemidir	önem
önemin	önem
öneminden	önem
önemine	önem
önemini	önem
öneminin	önem
önemle	önem
önemleri	önem
önemli	önem
önemlidir	önem
önemlidirler	önem
önemlileri	önem
önemlilerinden	önem
önemlilerindendir	önem
önemlilik	önem
önemlisi	önem
önemlisidir	önem
önemlisini	önem
önemliydi	önem
önemliyse	önem
önemsediği	önemse
önemsediğimiz	önemse
önemsemeden	önemse
önemsemektedir	önemse
önemsemeyen	önemse
önemsemiyor	önemse
önemsenmesi	önemsen
önemsenmeyecek	önemsen
önemsenmeyen	önemsen
önemsenmez	önemsen
önemser	önemse
önemseyen	önemse
önemsiyor	önems
önemsiyorum	önems
önemsiyoruz	önems
önemsiz	önem
önemsizdir	önem
önen	önen
öner	öne
öner'in	öner
önerdi	öner
önerdiği	öner
önerdiğimiz	öner
önerdik	öner
önerdikleri	öner
önerdiler	öner
önerebilir	öner
önerebilirsiniz	öner
önereceği	öner
önereceğiniz	öner
önerecektir	öner
öneren	öner
önerenler	öner
öneri	öner
öneride	öneri
öneriden	öneri
öneridir	öner
önerildi	öner
önerildiği	öner
önerilebilecek	öner
önerilebilir	öner
önerilecek	öner
önerilecektir	öner
önerilen	öner
önerilenler	öner
öneriler	öneri
önerilerde	öneri
önerilerden	öneri
önerilere	öneri
önerilerek	öner
önerileri	öneri
önerilerimiz	öneri
önerilerimizi	öneri
önerilerin	öneri
önerilerinde	öneri
önerilerinden	öneri
önerilerine	öneri
önerilerini	öneri
önerilerinin	öneri
önerileriniz	öneri
önerilerinizi	öneri
önerileriyle	öneri
önerilerle	öneri
önerilir	öner
öneriliyor	öner
önerilmekte	öner
önerilmektedir	öner
önerilmelidir	öner
önerilmemektedir	öner
önerilmesi	öner
önerilmesine	öner
önerilmez	öner
önerilmiş	öner
önerilmişti	öner
önerilmiştir	öner
önerilmiyor	öner
önerim	öne
önerimiz	öner
önerinin	öner
öneriniz	öner
önerinizi	öner
önerir	öner
öneririm	öner
öneririz	öner
önerirler	öner
önerirsiniz	öner
önerisi	öneri
önerisinde	öneri
önerisine	öneri
önerisini	öneri
önerisinin	öneri
önerisiyle	öneri
öneriye	öneri
öneriyi	öneri
öneriyor	öner
öneriyordu	öner
öneriyorlar	öner
öneriyorum	öner
öneriyoruz	öner
önerme	öner
önermek	öner
önermekte	öner
önermektedir	öner
önermektedirler	öner
önermeler	öner
önermeleri	öner
önermenin	öner
önermesi	öner
önermesinin	öner
önermeyi	öner
önermiş	öner
önermişlerdir	öner
önermişti	öner
önermiştir	öner
öney	öney
önizleme	önizle
önkayıt	önkayıt
önkoşul	önkoşul
önkoşullu	önkoşul
önkoşulu	önkoşul
önkoşuludur	önkoşul
önkol	önkol
önlü	ön
önlüğü	önlüğ
önlük	önlük
önlükleri	önlük
önlüyor	önl
önledi	önle
önlediği	önle
önlem	önlem
önlemdir	önlem
önleme	önle
önlemede	önle
önlemek	önle
önlemekte	önle
önlemektedir	önle
önlemektir	önle
önlemelidir	önle
önlemenin	önle
önlemesi	önle
önlemeye	önle
önlemeyi	önle
önlemez	önle
önlemi	önlem
önlemiş	önle
önlemiştir	önle
önlemin	önlem
önlemler	önlem
önlemlerden	önlem
önlemlerdir	önlem
önlemlere	önlem
önlemleri	önlem
önlemlerin	önlem
önlemlerine	önlem
önlemlerini	önlem
önlemlerinin	önlem
önlemleriyle	önlem
önlemlerle	önlem
önlendi	ön
önlendiği	ön
önlenebileceğini	ön
önlenebilecek	ön
önlenebilir	ön
önlenebilmesi	ön
önlenecek	ön
önlenecektir	ön
önlenemeyen	ön
önlenemez	ön
önlenerek	ön
önlenir	ön
önlenmek	ön
önlenmektedir	ön
önlenmeli	ön
önlenmelidir	ön
önlenmesi	ön
önlenmesidir	ön
önlenmesinde	ön
önlenmesine	ön
önlenmesini	ön
önlenmesinin	ön
önlenmiş	ön
önlenmiştir	ön
önler	ön
önleri	ön
önlerinde	ön
önlerindeki	ön
önlerine	ön
önlerini	ön
önlerken	önle
önlerler	önle
önlersiniz	önle
önleyebilecek	önle
önleyebilir	önle
önleyebilirsiniz	önle
önleyebilmek	önle
önleyebilmektedir	önle
önleyecek	önle
önleyecektir	önle
önleyemedi	önle
önleyemez	önle
önleyen	önle
önleyerek	önle
önleyici	önle
önleyin	önle
önleyiniz	önle
önlisans	önlisans
önsöz	önsöz
önsözü	önsöz
önsözünde	önsöz
öpüşme	öpüş
öpücük	öpücük
öpüp	öp
öpüyor	öp
öpüyorum	öp
öpen	öp
öper	öp
öperek	öp
öperim	öp
öperken	öp
öpme	öp
öpmek	öp
öpmeye	öp
öptü	öp
öptüm	öp
ör	ör
örülü	örü
örülür	ör
örülecek	ör
örülen	ör
örülmüş	ör
örümcek	örümcek
örümceklerin	örümcek
örüntü	örüntü
örüntüler	örüntü
örüntüleri	örüntü
örüntülerin	örüntü
örüntülerinin	örüntü
örüntünün	örüntü
örüntüsü	örüntü
örüntüsünün	örüntü
ördüğü	ör
ördeği	ördeğ
ördeğin	ördeğ
ördek	ördek
ördekler	ördek
ördeklerin	ördek
ören	ör
örer	ör
örf	örf
örfi	örfi
örğüt'ün	örğüt
örğütü'nü	örğütü
örğütü'nün	örğütü
örğütü'ne	örğütü
örme	ör
örmek	ör
örneğe	örneğ
örneği	örneğ
örneğidir	örneğ
örneğimiz	örneğ
örneğimizde	örneğ
örneğin	örneğin
örneğinde	örneğ
örneğindeki	örneğ
örneğinden	örneğ
örneğine	örneğ
örneğini	örneğ
örneğinin	örneğ
örneğiyle	örneğ
örneği	örneğ
örneğidir	örneğ
örneğin	örneğin
örneğini	örneğ
örnek	örnek
örnekle	örnek
örneklem	örneklem
örnekleme	örnekle
örneklemek	örnekle
örneklemeler	örnekle
örneklemelerle	örnekle
örneklemesi	örnekle
örneklemeye	örnekle
örneklemi	örneklem
örneklemini	örneklem
örnekler	örnek
örneklerde	örnek
örneklerdeki	örnek
örneklerden	örnek
örneklerdir	örnekle
örneklere	örnek
örnekleri	örnek
örnekleridir	örnek
örneklerin	örnek
örneklerinde	örnek
örneklerindeki	örnek
örneklerinden	örnek
örneklerindendir	örnek
örneklerine	örnek
örneklerini	örnek
örneklerinin	örnek
örnekleriyle	örnek
örneklerle	örnek
örnekli	örnek
örneksel	örnek
örnekte	örnek
örnekteki	örnek
örnekten	örnek
örnektir	örnek
örs	örs
örtü	örtü
örtüşür	örtüş
örtüşüyor	örtüş
örtüşen	örtüş
örtüşme	örtüş
örtüşmektedir	örtüş
örtüşmesi	örtüş
örtüştüğü	örtüş
örtücü	ört
örtük	örtük
örtülü	örtülü
örtülüdür	örtü
örtülür	ört
örtülen	ört
örtüler	örtü
örtülerek	ört
örtüleri	örtü
örtülerin	örtü
örtülmüş	ört
örtülmüştür	ört
örtülmesi	ört
örtün	ört
örtünün	örtü
örtünüz	ört
örtünme	örtün
örtüp	ört
örtüsü	örtü
örtüsüdür	örtü
örtüsünü	örtü
örtüsünün	örtü
örtüsünde	örtü
örtüsüne	örtü
örtüsüyle	örtü
örtüyü	örtü
örtüye	örtü
örtüyle	örtü
örtbas	örtbas
örtecek	ört
örten	ört
örter	ört
örterek	ört
örtmüş	ört
örtme	ört
örtmek	ört
örtmektedir	ört
örtmesi	ört
örtmeye	ört
örttü	ört
örttüğü	ört
öss	öss
öss'de	öss
öss'ye	öss
öss'yi	öss
östaki	östaki
östrojen	östrojen
östrojenin	östrojen
ösym	ösym
ösym'ce	ösym
ösym'de	ösym
ösym'nin	ösym
ösym'ye	ösym
ösys	ösys
öt	öt
ötüken	ötüken
ötürü	ötürü
ötanazi	ötanazi
öte	öte
ötede	öte
ötedeki	öte
öteden	öte
öteki	öteki
öteki'nin	öteki
ötekiler	öteki
ötekinden	öteki
ötekine	öteki
ötekini	öteki
ötekinin	öteki
ötekisine	öteki
öteleme	ötele
ötelerden	öte
ötelere	öte
öten	öt
ötenazi	ötenazi
ötenel	ötenel
ötenel'in	ötenel
öter	öt
ötesi	öte
ötesinde	öte
ötesindedir	öte
ötesindeki	öte
ötesinden	öte
ötesine	öte
ötesini	öte
ötesinin	öte
öteye	öte
ötv	ötv
övücü	öv
övün	öv
övünç	övünç
övünülecek	öv
övünüyor	övün
övünüyoruz	övün
övünen	övün
övünerek	övün
övünmek	övün
övdü	öv
öven	öv
över	öv
övme	öv
övmek	öv
öy	öy
öyk	öyk
öykü	öykü
öykücü	öykü
öyküde	öykü
öyküden	öykü
öyküler	öykü
öykülerden	öykü
öyküleri	öykü
öykülerin	öykü
öykülerinde	öykü
öykülerinden	öykü
öykülerini	öykü
öykülerinin	öykü
öykünün	öykü
öyküsü	öykü
öyküsüdür	öykü
öyküsünü	öykü
öyküsünün	öykü
öyküsünde	öykü
öyküsünden	öykü
öyküsüne	öykü
öyküsüyle	öykü
öyküyü	öykü
öyküye	öykü
öyküyle	öykü
öyle	öyle
öylece	öyle
öyledir	öyle
öyleki	öylek
öylesine	öylesine
öyleydi	öyle
öyleyse	öyle
öymen	öymen
öz	öz
özçelik	özçelik
özü	öz
özüdür	öz
özüdoğru	özüdoğru
özüm	öz
özümseme	özümse
özümsemek	özümse
özümsemiş	özümse
özümseyerek	özümse
özün	öz
özünü	öz
özünün	öz
özünde	öz
özündeki	öz
özünden	öz
özüne	öz
özür	özür
özürü	özür
özürlü	özürlü
özürlüdür	özürlü
özürlülüğün	özürlü
özürlülük	özürlü
özürlüler	özürlü
özürlülere	özürlü
özürlülerin	özürlü
özürlülerle	özürlü
özürlünün	özürlü
özürlüye	özürlü
özürler	özür
özürleri	özür
özürsüz	özür
özal	özal
özal'ı	özal
özal'ın	özal
özal'a	özal
özal'la	özal
özalp	özalp
özaltın	özaltın
özarslan	özarslan
özaslan	özaslan
özatay	özatay
özay	özay
özaydın	özaydın
özaydemir	özaydemir
özbaş	özbaş
özbal	özbal
özbay	özbay
özbek	özbek
özbek'in	özbek
özbekistan	özbekistan
özbekistan'ın	özbekistan
özbekistan'da	özbekistan
özbey	özbey
özbudun	özbudun
özcan	özcan
özcan'ın	özcan
özcan'a	özcan
özdağ	özdağ
özdal	özdal
özde	öz
özdeğer	özdeğer
özdeğerlendirme	özdeğer
özdeğerler	özdeğer
özdeş	özdeş
özdeşleşen	özdeş
özdeşleşmiş	özdeş
özdeşleşmiştir	özdeş
özdeşlik	özdeş
özdeştir	özdeş
özdek	özdek
özdemir	özdemir
özdemir'in	özdemir
özden	özden
özden'in	özden
özdenetim	özdenetim
özdevimli	özdevim
özdilek	özdilek
özdirenç	özdirenç
özdoğan	özdoğan
özdoğru	özdoğru
öze	öz
özek	özek
özel	özel
özelde	özel
özeldir	özel
özele	özel
özeleştiri	özeleştiri
özelikle	öze
özelikler	öze
özelikleri	öze
özelinde	özel
özelleşme	özel
özelleşmenin	özel
özelleşmesi	özel
özelleşmiş	özel
özelleşmiştir	özel
özelleştir	özel
özelleştirebilirsiniz	özel
özelleştirildi	özel
özelleştirilebilir	özel
özelleştirilecek	özel
özelleştirilen	özel
özelleştirilerek	özel
özelleştirilme	özel
özelleştirilmesi	özel
özelleştirilmesinde	özel
özelleştirilmesinden	özel
özelleştirilmesine	özel
özelleştirilmesini	özel
özelleştirilmesinin	özel
özelleştirilmiş	özel
özelleştirilmiştir	özel
özelleştirin	özel
özelleştirme	özel
özelleştirmede	özel
özelleştirmeden	özel
özelleştirmek	özel
özelleştirmeler	özel
özelleştirmelerin	özel
özelleştirmenin	özel
özelleştirmeye	özel
özelleştirmeyi	özel
özelleştirmeyle	özel
özelliğe	özelliğ
özelliği	özelliğ
özelliğidir	özelliğ
özelliğin	özelliğ
özelliğinde	özelliğ
özelliğindedir	özelliğ
özelliğindeki	özelliğ
özelliğinden	özelliğ
özelliğine	özelliğ
özelliğini	özelliğ
özelliğinin	özelliğ
özelliğiyle	özelliğ
özelliği	özelliğ
özelliğinden	özelliğ
özelliğine	özelliğ
özelliğini	özelliğ
özelliğinin	özelliğ
özellik	özellik
özellikle	özellikle
özellikler	özellik
özelliklerde	özellik
özelliklerdeki	özellik
özelliklerden	özellik
özelliklerdir	özellik
özelliklere	özellik
özellikleri	özellik
özellikleridir	özellik
özelliklerimiz	özellik
özelliklerin	özellik
özelliklerinde	özellik
özelliklerinden	özellik
özelliklerindendir	özellik
özelliklerine	özellik
özelliklerini	özellik
özelliklerinin	özellik
özelliklerinizi	özellik
özellikleriyle	özellik
özelliklerle	özellik
özellikli	özellik
özellikte	özellik
özelliktedir	özellik
özellikteki	özellik
özellikten	özellik
özelliktir	özellik
özemre	özemre
özen	öze
özenç	özenç
özendirecek	özen
özendiren	özen
özendirici	özen
özendirilecek	özen
özendirilecektir	özen
özendirilir	özen
özendirilmektedir	özen
özendirilmeli	özen
özendirilmelidir	özen
özendirilmesi	özen
özendirir	özen
özendirme	özen
özendirmek	özen
özene	öze
özenen	özen
özenerek	özen
özeni	öze
özenin	öze
özenle	öze
özenli	özenli
özensiz	özen
özenti	özenti
özer	öze
özer'e	özer
özer'in	özer
özeren	özeren
özerk	özerk
özerkliğe	özerkliğ
özerkliği	özerkliğ
özerkliğin	özerkliğ
özerkliğine	özerkliğ
özerkliğinin	özerkliğ
özerkliği	özerkliğ
özerklik	özerklik
özerler	öze
özesmi	özesmi
özet	özet
özeti	özet
özetidir	özet
özetin	özet
özetinde	özet
özetine	özet
özetini	özet
özetinin	özet
özetle	özet
özetledi	özetle
özetlediğim	özetle
özetleme	özetle
özetlemek	özetle
özetlemektedir	özetle
özetlemeye	özetle
özetlemiştir	özetle
özetlendiği	özetle
özetlenebilecek	özetle
özetlenebilir	özetle
özetlenen	özetle
özetlenerek	özetle
özetlenir	özetle
özetlenmektedir	özetle
özetlenmesi	özetle
özetlenmiş	özetle
özetlenmiştir	özetle
özetler	özet
özetleri	özet
özetlerin	özet
özetlerini	özet
özetlerinin	özet
özetlersek	özetle
özetleyebiliriz	özetle
özetleyecek	özetle
özetleyen	özetle
özetleyerek	özetle
özetleyiniz	özetle
özetliyor	özetl
özetliyordu	özetl
özette	özet
özhan	özhan
özhaseki	özhaseki
özilhan	özilhan
özkök	özkök
özkök'ün	özkök
özköse	özköse
özkafa	özkafa
özkan	özkan
özkan'ı	özkan
özkan'ın	özkan
özkan'a	özkan
özkan'dan	özkan
özkan'la	özkan
özkanlı	özkan
özkara	özkar
özkaya	özkay
özkaynak	özkaynak
özkaynakları	özkaynak
özkaynakların	özkaynak
özkaynaklarının	özkaynak
özkul	özkul
özkutlu	özkutlu
özlü	özlü
özlük	öz
özlüyor	özl
özlüyorum	özl
özlüyoruz	özl
özle	öz
özlediği	özle
özlediğimiz	özle
özledik	özle
özledim	özle
özlem	özlem
özleme	özle
özlemi	özlem
özlemim	özlem
özlemin	özlem
özlemini	özlem
özlemiyle	özlem
özlemle	özlem
özlemler	özlem
özlemleri	özlem
özlemlerine	özlem
özlemlerini	özlem
özlen	özlen
özlenen	öz
özler	öz
özleri	öz
özlerim	öz
özman	özman
özman'ın	özman
özmen	özmen
özmen'in	özmen
özne	öz
öznel	öznel
özneler	özne
öznenin	özne
öznesi	özne
öznitelik	öznitelik
öznur	öznur
özpolat	özpolat
özrü	özr
özsermaye	özsermaye
özsoy	özsoy
özsoylu	özsoy
özsuyu	özsu
öztürk	öztürk
öztürk'ün	öztürk
öztürk'e	öztürk
öztürkçe	öztürk
öztürkmen	öztürkmen
öztaş	öztaş
öztan	öztan
öztek	öztek
öztop	öztop
öztoprak	öztoprak
öztuna	öztuna
özturan	özturan
özvektörler	özvektör
özveren	özveren
özveri	özveri
özveride	özveri
özverili	özveri
özverisi	özveri
özveriye	özveri
özveriyi	özveri
özveriyle	özveri
özyılmaz	özyılmaz
özyürek	özyürek
özyurt	özyurt
ş	ş
ş'nin	ş
ş'ye	ş
şık	şık
şıkır	şıkır
şıkkı	şıkk
şıkkında	şıkk
şıklığı	şık
şıklık	şık
şıkları	şık
şıklarından	şık
şımarık	şımarık
şıp	şıp
şırıl	şırıl
şırnak	şırnak
şırnak'ın	şırnak
şırnak'a	şırnak
şırnak'ta	şırnak
şöför	şöför
şöhret	şöhret
şöhrete	şöhret
şöhreti	şöhret
şöhretin	şöhret
şöhretli	şöhret
şölen	şölen
şölende	şölen
şölene	şölen
şöleni	şölen
şölenin	şölen
şöleninde	şölen
şölenine	şölen
şölenleri	şölen
şömine	şömine
şövalye	şövalye
şövalyeler	şövalye
şövalyeleri	şövalye
şöyle	şöyle
şöyleki	şöyleki
şükür	şükür
şükürler	şükür
şükrü	şükr
şükrüpaşa	şükrüpaşa
şükran	şükran
şükranla	şükran
şükranlarımı	şükran
şükranlarımızı	şükran
şükranlarını	şükran
şükrediyorum	şükred
şükriye	şükriye
şümulüne	şümul
şüphe	şüphe
şüpheci	şüphe
şüphelendiğiniz	şüphelen
şüphelenildiğinde	şüphelen
şüphelenilen	şüphelen
şüphelenilir	şüphelen
şüpheleniliyorsa	şüphelen
şüphelenilmelidir	şüphelen
şüpheleniyorsanız	şüphelen
şüpheler	şüphe
şüpheleri	şüphe
şüphelerin	şüphe
şüpheli	şüphe
şüphelidir	şüphe
şüpheliler	şüphe
şüphelilerin	şüphe
şüphelinin	şüphe
şüphem	şüphe
şüphemiz	şüphe
şüphenin	şüphe
şüpheniz	şüphe
şüphesi	şüphe
şüphesini	şüphe
şüphesiyle	şüphe
şüphesiz	şüphesiz
şüphesizdir	şüphe
şüpheye	şüphe
şüpheyle	şüphe
şa	şa
şaş	şaş
şaşı	şaşı
şaşılığın	şaşı
şaşılık	şaşı
şaşılacak	şaş
şaşırıp	şaşır
şaşırır	şaşır
şaşırıyor	şaşır
şaşırıyorum	şaşır
şaşıracaksınız	şaşır
şaşıran	şaşır
şaşırdı	şaşır
şaşırdık	şaşır
şaşırdılar	şaşır
şaşırdım	şaşır
şaşırmış	şaşır
şaşırmıştı	şaşır
şaşırmıştım	şaşır
şaşırmadan	şaşır
şaşırmamak	şaşır
şaşırmayın	şaşır
şaşırtıcı	şaşır
şaşırtıcıydı	şaşır
şaşırtıyor	şaşır
şaşırtacak	şaşır
şaşırtan	şaşır
şaşırtmıştı	şaşır
şaşırtmaya	şaşır
şaşırttı	şaşır
şaşal	şaşal
şaşar	şaş
şaşi	şaşi
şaşkın	şaşkın
şaşkına	şaşkın
şaşkınlığı	şaşkın
şaşkınlığını	şaşkın
şaşkınlığa	şaşkın
şaşkınlık	şaşkın
şaşkınlıkla	şaşkın
şaşkınlıklarını	şaşkın
şaşkınlıktan	şaşkın
şaşmamak	şaş
şaşmayın	şaş
şaşmaz	şaşmaz
şaban	şaban
şabat	şabat
şablon	şablon
şablonlar	şablon
şablonları	şablon
şablonu	şablon
şablonun	şablon
şad	şad
şadırvan	şadırvan
şadi	şadi
şadiye	şadi
şafak	şafak
şaft	şaft
şaftın	şaft
şaftlar	şaft
şaftları	şaft
şah	şah
şah'ın	şah
şahı	şah
şahın	şah
şahıs	şahıs
şahısa	şahıs
şahısla	şahıs
şahıslar	şahıs
şahısları	şahıs
şahısların	şahıs
şahıslarına	şahıs
şahıslara	şahıs
şahıslarca	şahıs
şahıslardan	şahıs
şahıslarla	şahıs
şahıstan	şahıs
şaha	şah
şahabettin	şahabettin
şahadet	şahadet
şahadetnamesi	şahadetname
şahan	şahan
şahane	şahane
şahap	şahap
şahbaz	şahbaz
şahenk'in	şahenk
şaheser	şaheser
şaheseri	şaheser
şahid	şahid
şahidi	şahid
şahin	şahin
şahin'e	şahin
şahin'in	şahin
şahinbey	şahinbey
şahinkaya	şahinkaya
şahinler	şahin
şahit	şahit
şahitler	şahit
şahitleri	şahit
şahitlerin	şahit
şahitliğini	şahit
şahitlik	şahit
şahittir	şahit
şahlan	şahlan
şahsı	şah
şahsım	şahs
şahsıma	şahs
şahsın	şahs
şahsınız	şahs
şahsınıza	şahs
şahsına	şahs
şahsında	şahs
şahsa	şah
şahsen	şahsen
şahsi	şahsi
şahsiyet	şahsiyet
şahsiyete	şahsiyet
şahsiyeti	şahsiyet
şahsiyetine	şahsiyet
şahsiyetini	şahsiyet
şahsiyetler	şahsiyet
şahsiyetleri	şahsiyet
şahsiyetlerin	şahsiyet
şahsiyetlerini	şahsiyet
şahsiyetli	şahsiyet
şahsiyettir	şahsiyet
şaibe	şaibe
şaibeli	şaibe
şair	şair
şairdi	şair
şairdir	şair
şaire	şair
şairi	şair
şairidir	şair
şairimiz	şair
şairimizin	şair
şairin	şair
şairinin	şair
şairler	şair
şairlerden	şair
şairlere	şair
şairleri	şair
şairlerimiz	şair
şairlerimizin	şair
şairlerin	şair
şairlerinden	şair
şairlerinin	şair
şakır	şakır
şaka	şaka
şakalar	şaka
şakası	şaka
şakaya	şaka
şakir	şakir
şakirpaşa	şakirpaşa
şakrak	şakrak
şal	şal
şalom	şalom
şalt	şalt
şalter	şalter
şalteri	şalter
şalterler	şalter
şalterleri	şalter
şalvar	şalvar
şam	şa
şam'ı	şam
şam'a	şam
şam'da	şam
şam'daki	şam
şaman	şama
şamanizm	şamanizm
şamata	şamata
şamdan	şa
şamil	şamil
şamildir	şamil
şamlı	şamlı
şampanya	şampanya
şampiyon	şampiyon
şampiyona	şampiyon
şampiyonada	şampiyona
şampiyonaları	şampiyona
şampiyonanın	şampiyona
şampiyonası	şampiyona
şampiyonası'nın	şampiyonası
şampiyonası'na	şampiyonası
şampiyonası'nda	şampiyonası
şampiyonasına	şampiyona
şampiyonasında	şampiyona
şampiyonaya	şampiyona
şampiyonlar	şampiyon
şampiyonları	şampiyon
şampiyonluğa	şampiyon
şampiyonluğu	şampiyon
şampiyonluğunu	şampiyon
şampiyonluk	şampiyon
şampiyonu	şampiyon
şampuan	şampuan
şampuanı	şampuan
şan	şa
şanı	şa
şanına	şan
şanar	şanar
şankaya	şankaya
şanlı	şanlı
şanlıurfa	şanlıurfa
şanlıurfa'da	şanlıurfa
şanlıurfa'nın	şanlıurfa
şanlıurfa'ya	şanlıurfa
şans	şans
şansı	şans
şansım	şans
şansımı	şans
şansımız	şans
şansımızı	şans
şansımızın	şans
şansın	şans
şansını	şans
şansının	şans
şansınız	şans
şansınızı	şans
şansınızın	şans
şansına	şans
şansa	şans
şanslı	şans
şanslısınız	şans
şanslar	şans
şansları	şans
şanslarını	şans
şanslarının	şans
şanssız	şans
şanssızlık	şans
şanstı	şans
şant	şant
şantaj	şantaj
şantiye	şantiye
şantiyede	şantiye
şantiyeden	şantiye
şantiyelerde	şantiye
şantiyeleri	şantiye
şantiyeye	şantiye
şantiyeyi	şantiye
şanzıman	şanzıman
şap	şap
şapel	şapel
şapka	şapka
şapkalı	şapka
şapkalar	şapka
şapkaları	şapka
şapkalarını	şapka
şapkanın	şapka
şapkası	şapka
şapkasını	şapka
şapkayı	şapka
şar	şar
şarık	şarık
şarabı	şarab
şarabın	şarab
şaraba	şarab
şarampole	şarampol
şarap	şarap
şarapçılık	şarap
şaraplık	şarap
şaraplar	şarap
şarapları	şarap
şarapların	şarap
şaraplarda	şarap
şarapnel	şarapnel
şaraptan	şarap
şarbon	şarbon
şarbonu	şarbon
şarj	şarj
şarjı	şarj
şarjlı	şarj
şark	şark
şarkı	şark
şarkışla	şarkışla
şarkıcı	şarkı
şarkıcılar	şarkı
şarkıcıların	şarkı
şarkıcının	şarkı
şarkıcısı	şarkı
şarkıda	şarkı
şarkılar	şarkı
şarkıları	şarkı
şarkıların	şarkı
şarkılarını	şarkı
şarkılarının	şarkı
şarkılarından	şarkı
şarkılarıyla	şarkı
şarkılara	şarkı
şarkılarda	şarkı
şarkılardan	şarkı
şarkılarla	şarkı
şarkının	şark
şarkısı	şarkı
şarkısını	şarkı
şarkısının	şarkı
şarkıyı	şarkı
şarkıya	şarkı
şarkıyla	şark
şarköy	şarköy
şarküteri	şarküteri
şarki	şarki
şarkiye	şarkiye
şarlatan	şarlatan
şaron	şaron
şaron'un	şaron
şart	şart
şartı	şart
şartı'nın	şartı
şartıdır	şart
şartımız	şart
şartın	şart
şartını	şart
şartının	şart
şartına	şart
şartında	şart
şartıyla	şart
şarta	şart
şartlı	şart
şartla	şart
şartlandırılmış	şart
şartlandırma	şart
şartlar	şart
şartları	şart
şartlarımız	şart
şartların	şart
şartlarını	şart
şartlarının	şart
şartlarına	şart
şartlarında	şart
şartlarındaki	şart
şartlarından	şart
şartlarıyla	şart
şartlara	şart
şartlarda	şart
şartlardan	şart
şartlarla	şart
şartname	şartname
şartnamede	şartname
şartnameler	şartname
şartnamelerde	şartname
şartnamelere	şartname
şartnameleri	şartname
şartnamelerin	şartname
şartnamelerinde	şartname
şartnamelerine	şartname
şartnamelerinin	şartname
şartnamenin	şartname
şartnamesi	şartname
şartnamesinde	şartname
şartnamesine	şartname
şartnamesini	şartname
şartnamesinin	şartname
şartnameye	şartname
şartnameyi	şartname
şartsız	şart
şarttı	şart
şarttır	şart
şartta	şart
şase	şase
şasi	şasi
şasisi	şasi
şat	şat
şatıroğlu	şatıroğlu
şatafatlı	şatafat
şato	şato
şavşat	şavşat
şayan	şayan
şayet	şayet
şb	şb
şc'de	şc
şebeke	şebeke
şebekede	şebeke
şebekedeki	şebeke
şebekeden	şebeke
şebekeler	şebeke
şebekelerde	şebeke
şebekelere	şebeke
şebekeleri	şebeke
şebekelerin	şebeke
şebekelerinde	şebeke
şebekelerinden	şebeke
şebekelerine	şebeke
şebekelerini	şebeke
şebekelerinin	şebeke
şebekenin	şebeke
şebekesi	şebeke
şebekesinde	şebeke
şebekesinden	şebeke
şebekesine	şebeke
şebekesini	şebeke
şebekesinin	şebeke
şebekeye	şebeke
şebekeyi	şebeke
şebinkarahisar	şebinkarahisar
şebnem	şebnem
şef	şef
şeffaf	şeffaf
şeffaflığı	şeffaf
şeffaflığın	şeffaf
şeffaflığını	şeffaf
şeffaflık	şeffaf
şeffaftır	şeffaf
şefi	şef
şefik	şefik
şefika	şefika
şefimiz	şef
şefin	şef
şefine	şef
şefinin	şef
şefkat	şefkat
şefkate	şefkat
şefkati	şefkat
şefkatini	şefkat
şefkatle	şefkat
şefkatli	şefkat
şefler	şef
şefleri	şef
şeflerine	şef
şeflerinin	şef
şeflerle	şef
şefliği	şef
şefliğince	şef
şefliğine	şef
şefliğini	şef
şeflik	şef
şeflikleri	şef
şefliklerinin	şef
şeftali	şeftali
şehabettin	şehabettin
şehadet	şehadet
şehidi	şehid
şehir	şehir
şehircilik	şehir
şehirde	şehir
şehirdeki	şehir
şehirden	şehir
şehirdi	şehir
şehirdir	şehir
şehire	şehir
şehiri	şehir
şehiriçi	şehiriç
şehirle	şehir
şehirleşme	şehir
şehirleşmenin	şehir
şehirler	şehir
şehirlerde	şehir
şehirlerdeki	şehir
şehirlerden	şehir
şehirlere	şehir
şehirleri	şehir
şehirlerimiz	şehir
şehirlerimizde	şehir
şehirlerimizin	şehir
şehirlerin	şehir
şehirlerinde	şehir
şehirlerinden	şehir
şehirlerine	şehir
şehirlerini	şehir
şehirlerinin	şehir
şehirlerle	şehir
şehirli	şehir
şehirsel	şehir
şehit	şehit
şehitler	şehit
şehitleri	şehit
şehitlerimiz	şehit
şehitlerimize	şehit
şehitlerimizi	şehit
şehitlerin	şehit
şehitlik	şehitlik
şehname	şehname
şehnaz	şehnaz
şehre	şehr
şehremaneti	şehremanet
şehremini	şehremini
şehri	şehr
şehriban	şehriban
şehridir	şehr
şehrimiz	şehr
şehrimizde	şehr
şehrimizdeki	şehr
şehrimize	şehr
şehrimizi	şehr
şehrimizin	şehr
şehrin	şehr
şehrinde	şehr
şehrindeki	şehr
şehrinden	şehr
şehrine	şehr
şehrini	şehr
şehrinin	şehr
şehvet	şehvet
şehzade	şehzade
şehzadebaşı	şehzadebaşı
şehzadeler	şehzade
şek	şek
şeker	şeker
şekerbank	şekerbank
şekerci	şekerci
şekerden	şeker
şekere	şeker
şekeri	şeker
şekerin	şeker
şekerini	şeker
şekerinin	şeker
şekeriniz	şeker
şekerinizin	şeker
şekerle	şeker
şekerleme	şekerle
şekerlemeler	şekerleme
şekerler	şeker
şekerleri	şeker
şekerlerin	şeker
şekerli	şekerli
şekeroğlu	şekeroğlu
şekerpancarı	şekerpancar
şekersiz	şeker
şekerspor	şekerspor
şekil	şekil
şekilde	şekil
şekildedir	şekil
şekildeki	şekil
şekilden	şekil
şekille	şekil
şekillendi	şekillen
şekillendiği	şekillen
şekillendiğini	şekillen
şekillendirdiği	şekillen
şekillendirecek	şekillen
şekillendiren	şekillen
şekillendirilen	şekillen
şekillendirilir	şekillen
şekillendirilmektedir	şekillen
şekillendirilmesi	şekillen
şekillendirilmiş	şekillen
şekillendirilmiştir	şekillen
şekillendirir	şekillen
şekillendiriyor	şekillen
şekillendirme	şekillen
şekillendirmek	şekillen
şekillendirmeye	şekillen
şekillendirmiştir	şekillen
şekillenecek	şekillen
şekillenen	şekillen
şekillenir	şekillen
şekilleniyor	şekillen
şekillenme	şekillen
şekillenmektedir	şekillen
şekillenmesi	şekillen
şekillenmesinde	şekillen
şekillenmeye	şekillen
şekillenmiş	şekillen
şekillenmiştir	şekillen
şekiller	şekil
şekillerde	şekil
şekillerdeki	şekil
şekillerden	şekil
şekillere	şekil
şekilleri	şekil
şekillerin	şekil
şekillerinde	şekil
şekillerinden	şekil
şekillerine	şekil
şekillerini	şekil
şekillerinin	şekil
şekilleriyle	şekil
şekillerle	şekil
şekilli	şekil
şekilsel	şekil
şekilsiz	şekil
şekip	şekip
şekle	şek
şeklen	şeklen
şekli	şekli
şeklide	şekli
şeklidir	şekli
şeklin	şekl
şeklinde	şekl
şeklindedir	şekl
şeklindeki	şekl
şeklinden	şekl
şeklindeydi	şekl
şekline	şekl
şeklini	şekl
şeklinin	şekl
şekliyle	şekl
şelale	şelale
şelaleler	şelale
şelaleleri	şelale
şelalenin	şelale
şelalesi	şelale
şelf	şelf
şema	şema
şemada	şema
şemahi'ye	şemahi
şemalar	şema
şemaları	şema
şemalarını	şema
şemalarının	şema
şeması	şema
şemasını	şema
şemasının	şema
şemasına	şema
şemasında	şema
şematik	şematik
şemaya	şema
şemdinli	şemdinli
şemo	şemo
şems	şems
şems'in	şems
şemseddin	şemseddin
şemsettin	şemsettin
şemsi	şemsi
şemsiye	şemsi
şemsiyeler	şemsiye
şemsiyenin	şemsiye
şemsiyesi	şemsiye
şemsiyeyi	şemsiye
şen	şen
şen'in	şen
şenalp	şenalp
şenay	şenay
şenel	şenel
şener	şener
şener'in	şener
şenğün'ün	şenğün
şeniz	şe
şenkal	şenkal
şenkaya	şenkaya
şenliğe	şenliğ
şenliği	şenliğ
şenliği'nde	şenliği
şenliğin	şenliğ
şenliğinde	şenliğ
şenliğine	şenliğ
şenlik	şenlik
şenlikle	şenlik
şenlikler	şenlik
şenliklerde	şenlik
şenliklere	şenlik
şenlikleri	şenlik
şenlikleri'nin	şenlikleri
şenliklerin	şenlik
şenliklerinde	şenlik
şenliklerine	şenlik
şenliklerinin	şenlik
şenlikte	şenlik
şenocak	şenocak
şenol	şenol
şenpazar	şenpazar
şenses	şenses
şensoy	şensoy
şentürk	şentürk
şenyüz	şenyüz
şenyuva	şenyuva
şer	şer
şer'i	şer
şerafettin	şerafettin
şerait	şerait
şeraiti	şerait
şeraitten	şerait
şerbet	şerbet
şerbetçi	şerbetçi
şerbeti	şerbet
şere	şer
şeref	şeref
şerefe	şeref
şerefeli	şerefeli
şerefi	şeref
şerefim	şeref
şerefine	şeref
şerefini	şeref
şerefiyle	şeref
şerefle	şeref
şereflerle	şeref
şerefli	şerefli
şereflisi	şerefli
şerefsiz	şeref
şerh	şerh
şerhe	şerh
şerhi	şerh
şerhin	şerh
şerhinde	şerh
şerhini	şerh
şerhler	şerh
şeri	şeri
şeria	şeria
şeriat	şeriat
şeriatçı	şeriat
şeriatın	şeriat
şeriata	şeriat
şeriatta	şeriat
şeride	şerid
şeridi	şerid
şeridin	şerid
şeridinde	şerid
şeridindeki	şerid
şeridine	şerid
şeridini	şerid
şeridinin	şerid
şerif	şerif
şerif'in	şerif
şerife	şerif
şerifi	şerif
şerifoğlu	şerifoğlu
şerifte	şerif
şerit	şerit
şeritler	şerit
şeritleri	şerit
şeritlerinde	şerit
şeritlerinin	şerit
şeritli	şeritli
şeritsi	şerit
şeritten	şerit
şeriye	şeriye
şermin	şermin
şerrinden	şerr
şev	şev
şevk	şevk
şevkat	şevkat
şevket	şevket
şevki	şevk
şevkle	şevk
şey	şey
şeyda	şeyda
şeyde	şey
şeyden	şey
şeydi	şe
şeydir	şey
şeye	şe
şeyh	şeyh
şeyh'in	şeyh
şeyhülislam	şeyhülislam
şeyhi	şeyh
şeyhin	şeyh
şeyhler	şeyh
şeyhlerinden	şeyh
şeyhmus	şeyhmus
şeyi	şe
şeyim	şey
şeyimi	şey
şeyimiz	şey
şeyimizi	şey
şeyin	şey
şeyini	şey
şeyiyle	şey
şeyle	şe
şeyler	şey
şeylerde	şey
şeylerden	şey
şeylerdi	şey
şeylerdir	şey
şeylere	şey
şeyleri	şey
şeylerin	şey
şeylerini	şey
şeylerle	şey
şeymiş	şe
şeytan	şeytan
şeytanı	şeytan
şeytanın	şeytan
şeytana	şeytan
şeytani	şeytani
şi	şi
şiş	şiş
şişe	şişe
şişecam	şişecam
şişecam'ın	şişecam
şişede	şişe
şişeden	şişe
şişek	şişek
şişeleme	şişele
şişelenmiş	şişe
şişeler	şiş
şişelerde	şişe
şişelere	şişe
şişeleri	şişe
şişelerin	şişe
şişen	şiş
şişenin	şişe
şişer	şiş
şişerek	şiş
şişesi	şişe
şişesini	şişe
şişesinin	şişe
şişeye	şişe
şişeyi	şişe
şişhane	şişhane
şişi	şiş
şişik	şişik
şişirilerek	şişir
şişirilir	şişir
şişirilmiş	şişir
şişirme	şişir
şişkin	şişkin
şişkinliği	şişkin
şişkinlik	şişkin
şişko	şişko
şişli	şişli
şişli'de	şişli
şişli'deki	şişli
şişliğe	şiş
şişliği	şiş
şişliğin	şiş
şişlik	şiş
şişlikler	şiş
şişman	şişman
şişmanlığın	şişman
şişmanlığa	şişman
şişmanlık	şişman
şişme	şiş
şişmesi	şiş
şişmesine	şiş
şişmeye	şiş
şişmiş	şiş
şişti	şiş
şiştiği	şiş
şiar	şiar
şiddet	şiddet
şiddete	şiddet
şiddeti	şiddet
şiddetin	şiddet
şiddetinde	şiddet
şiddetindeki	şiddet
şiddetinden	şiddet
şiddetine	şiddet
şiddetini	şiddet
şiddetinin	şiddet
şiddetiyle	şiddet
şiddetle	şiddet
şiddetlenir	şiddetlen
şiddetleri	şiddet
şiddetli	şiddet
şiddetlidir	şiddet
şiddette	şiddet
şiddetteki	şiddet
şiddetten	şiddet
şifa	şifa
şifahane	şifahane
şifahi	şifahi
şifalı	şifa
şifalar	şifa
şifre	şifre
şifrede	şifre
şifredir	şifre
şifreleme	şifrele
şifrelemek	şifrele
şifrelemesi	şifrele
şifrelenen	şifrele
şifrelenerek	şifrele
şifrelenir	şifrele
şifrelenmiş	şifrele
şifreler	şifre
şifreleri	şifre
şifrelerin	şifre
şifrelerini	şifre
şifrelerinin	şifre
şifrelerinizi	şifre
şifrelerle	şifre
şifreli	şifre
şifremi	şifre
şifrenin	şifre
şifreniz	şifre
şifrenizi	şifre
şifrenizin	şifre
şifrenizle	şifre
şifresi	şifre
şifresini	şifre
şifresinin	şifre
şifresiyle	şifre
şifresiz	şifre
şifreye	şifre
şifreyi	şifre
şifreyle	şifre
şii	şii
şiiler	şii
şiilik	şii
şiir	şiir
şiirde	şiir
şiirden	şiir
şiirdir	şiir
şiire	şiir
şiiri	şiir
şiirim	şiir
şiirin	şiir
şiirinde	şiir
şiirindeki	şiir
şiirinden	şiir
şiirine	şiir
şiirini	şiir
şiirinin	şiir
şiiriyle	şiir
şiirle	şiir
şiirler	şiir
şiirlerde	şiir
şiirlerden	şiir
şiirlere	şiir
şiirleri	şiir
şiirlerin	şiir
şiirlerinde	şiir
şiirlerindeki	şiir
şiirlerinden	şiir
şiirlerine	şiir
şiirlerini	şiir
şiirlerinin	şiir
şiirleriyle	şiir
şiirlerle	şiir
şiirsel	şiir
şikayet	şikayet
şikayetçi	şikayet
şikayetçidir	şikayet
şikayetçinin	şikayet
şikayete	şikayet
şikayeti	şikayet
şikayetim	şikayet
şikayetin	şikayet
şikayetine	şikayet
şikayetini	şikayet
şikayetinin	şikayet
şikayetiniz	şikayet
şikayetiyle	şikayet
şikayetler	şikayet
şikayetlerde	şikayet
şikayetlerden	şikayet
şikayetlere	şikayet
şikayetleri	şikayet
şikayetlerin	şikayet
şikayetlerinde	şikayet
şikayetlerine	şikayet
şikayetlerini	şikayet
şikayetlerinin	şikayet
şikayetleriniz	şikayet
şikayetlerinizi	şikayet
şikayetlerle	şikayet
şikayette	şikayet
şikel	şikel
şile	şile
şile'ye	şile
şili	şili
şili'de	şili
şilt	şilt
şilte	şilte
şilteleri	şilte
şiltesi	şilte
şimşek	şimşek
şimşek'in	şimşek
şimşekler	şimşek
şimşekleri	şimşek
şimşir	şimşir
şimal	şimal
şimdi	şimdi
şimdide	şimdi
şimdiden	şimdiden
şimdiki	şimdiki
şimdilerde	şimdilerde
şimdilik	şimdilik
şimdinin	şimdi
şimdiye	şimdi
şimdiyse	şimdi
şinasi	şinasi
şirin	şirin
şirin'in	şirin
şirince	şirin
şirinevler	şirinevler
şirinyalı	şirinyalı
şirk	şirk
şirket	şirket
şirket'in	şirket
şirketçe	şirket
şirkete	şirket
şirketi	şirket
şirketi'ni	şirketi
şirketi'nin	şirketi
şirketidir	şirket
şirketim	şirket
şirketimiz	şirket
şirketimizce	şirket
şirketimizde	şirket
şirketimizden	şirket
şirketimize	şirket
şirketimizi	şirket
şirketimizin	şirket
şirketin	şirket
şirketinde	şirket
şirketinden	şirket
şirketine	şirket
şirketini	şirket
şirketinin	şirket
şirketiniz	şirket
şirketinizde	şirket
şirketinize	şirket
şirketinizi	şirket
şirketinizin	şirket
şirketinizle	şirket
şirketiyle	şirket
şirketle	şirket
şirketleşme	şirket
şirketler	şirket
şirketlerce	şirket
şirketlerde	şirket
şirketlerdeki	şirket
şirketlerden	şirket
şirketlerdir	şirket
şirketlere	şirket
şirketleri	şirket
şirketleridir	şirket
şirketlerimiz	şirket
şirketlerimizi	şirket
şirketlerimizin	şirket
şirketlerin	şirket
şirketlerince	şirket
şirketlerinde	şirket
şirketlerinden	şirket
şirketlerine	şirket
şirketlerini	şirket
şirketlerinin	şirket
şirketleriyle	şirket
şirketlerle	şirket
şirkette	şirket
şirketteki	şirket
şirketten	şirket
şirkettir	şirket
şirvan	şirvan
şist	şist
şivan	şivan
şive	şive
şiveleri	şive
şizofreni	şizofren
şnorkel	şnorkel
şoför	şoför
şoförü	şoför
şoförün	şoför
şoförünün	şoför
şoföre	şoför
şoförler	şoför
şoförleri	şoför
şoförlerin	şoför
şoförlerinde	şoför
şoförlerinin	şoför
şofben	şofben
şok	şok
şoka	şok
şoke	şoke
şokla	şok
şoklar	şok
şokların	şok
şoklara	şok
şokta	şok
şoktan	şok
şoku	şok
şokun	şok
şokunu	şok
şor	şor
şoray	şoray
şort	şort
şose	şose
şov	şov
şoven	şoven
şovenizm	şovenizm
şovlar	şov
şti	şti
şu	şu
şuabatı	şuabatı
şuan	şua
şuanda	şua
şuara	şuara
şubat	şubat
şubat'ı	şubat
şubat'ın	şubat
şubat'a	şubat
şubat'ta	şubat
şubat'tan	şubat
şubatın	şubat
şubatında	şubat
şubatta	şubat
şube	şube
şubede	şube
şubedeki	şube
şubeden	şube
şubeleşme	şube
şubeler	şube
şubelerde	şube
şubelerdeki	şube
şubelerden	şube
şubelere	şube
şubeleri	şube
şubeleri'nden	şubeleri
şubelerimiz	şube
şubelerimizden	şube
şubelerimize	şube
şubelerimizin	şube
şubelerin	şube
şubelerince	şube
şubelerinde	şube
şubelerindeki	şube
şubelerinden	şube
şubelerine	şube
şubelerini	şube
şubelerinin	şube
şubeli	şube
şubemiz	şube
şubemizde	şube
şubemizden	şube
şubemize	şube
şubemizi	şube
şubemizin	şube
şubenin	şube
şubenize	şube
şubesi	şube
şubesi'nde	şubesi
şubesi'ndeki	şubesi
şubesi'nden	şubesi
şubesi'ne	şubesi
şubesi'ni	şubesi
şubesi'nin	şubesi
şubesinde	şube
şubesindeki	şube
şubesinden	şube
şubesine	şube
şubesini	şube
şubesinin	şube
şubesiyle	şube
şubeye	şube
şubeyi	şube
şudur	şu
şuf'a	şuf
şufa	şufa
şuhut	şuhut
şule	şule
şuna	şu
şunda	şu
şundan	şu
şunlar	şu
şunların	şunlar
şunlardı	şunlar
şunlardır	şu
şunu	şu
şunun	şu
şura	şura
şura'da	şura
şura'nın	şura
şurada	şurada
şuradan	şura
şurası	şura
şurası'nın	şurası
şurası'nda	şurası
şurasında	şura
şurayı	şura
şuraya	şura
şurda	şurda
şurubu	şurub
şurup	şurup
şurupları	şurup
şuur	şuur
şuura	şuur
şuurla	şuur
şuurlu	şuur
şuursuz	şuur
şuuru	şuur
şuurun	şuur
şuurunda	şuur
şuurunu	şuur
şuurunun	şuur
şuydu	şu
şuymuş	şu
üç	üç
üçü	üç
üçümüz	üç
üçün	üç
üçünü	üç
üçünün	üç
üçüncü	üçüncü
üçüncül	üçüncül
üçüncülüğü	üçüncü
üçüncülük	üçüncü
üçüncüsü	üçüncü
üçüncüsünde	üçüncü
üçüncüye	üçüncü
üçünde	üç
üçünden	üç
üçüne	üç
üçayak	üçayak
üçe	üç
üçer	üçer
üçlü	üç
üçlünün	üç
üçlüsü	üç
üçlüsünün	üç
üçlemenin	üçle
üçlemesi	üçle
üçler	üç
üçok	üçok
üçpınar	üçpınar
üçte	üç
üçten	üç
üçyüz	üçyüz
üşüdüğünü	üşü
üşümüş	üşü
üşüme	üşü
üşür	üşü
üşüyen	üşü
üşüyor	üş
ücra	ücra
ücret	ücret
ücrete	ücret
ücreti	ücret
ücretimi	ücret
ücretin	ücret
ücretinden	ücret
ücretine	ücret
ücretini	ücret
ücretinin	ücret
ücretle	ücret
ücretlendirilecektir	ücret
ücretlendirilir	ücret
ücretlendirilirsiniz	ücret
ücretlendiriliyor	ücret
ücretlendirilmektedir	ücret
ücretlendirilmesi	ücret
ücretlendirme	ücret
ücretlendirmesi	ücret
ücretler	ücret
ücretlerde	ücret
ücretlerden	ücret
ücretlerdir	ücretle
ücretlere	ücret
ücretleri	ücret
ücretlerin	ücret
ücretlerinde	ücret
ücretlerinden	ücret
ücretlerine	ücret
ücretlerini	ücret
ücretlerinin	ücret
ücretleriyle	ücret
ücretlerle	ücret
ücretli	ücret
ücretlidir	ücret
ücretliler	ücret
ücretlilerin	ücret
ücretlinin	ücret
ücretsiz	ücret
ücretsizdir	ücret
ücrette	ücret
ücretten	ücret
ücrettir	ücret
üds	üds
üfürüm	üfürüm
üfürümü	üfürüm
üfürümün	üfürüm
üfürümler	üfürüm
üfleme	üfle
üflemeli	üfle
üfleyen	üfle
üfleyerek	üfle
üfleyin	üfle
ülfet	ülfet
ülkü	ülkü
ülkü'nün	ülkü
ülkücü	ülkü
ülkücülük	ülkü
ülkücüler	ülkü
ülkümen	ülkümen
ülkünün	ülkü
ülküsü	ülkü
ülküsünü	ülkü
ülküsünün	ülkü
ülküye	ülkü
ülke	ülke
ülkede	ülke
ülkedeki	ülke
ülkeden	ülke
ülkedir	ülke
ülkeler	ülke
ülkelerce	ülke
ülkelerde	ülke
ülkelerdeki	ülke
ülkelerden	ülke
ülkelerdir	ülke
ülkelere	ülke
ülkeleri	ülke
ülkeleridir	ülke
ülkelerimiz	ülke
ülkelerimizin	ülke
ülkelerin	ülke
ülkelerinde	ülke
ülkelerindeki	ülke
ülkelerinden	ülke
ülkelerine	ülke
ülkelerini	ülke
ülkelerinin	ülke
ülkeleriyle	ülke
ülkelerle	ülke
ülkem	ülke
ülkemde	ülke
ülkemdeki	ülke
ülkeme	ülke
ülkemi	ülke
ülkemin	ülke
ülkemiz	ülke
ülkemizde	ülke
ülkemizdeki	ülke
ülkemizden	ülke
ülkemize	ülke
ülkemizi	ülke
ülkemizin	ülke
ülkemizle	ülke
ülken	ülke
ülkene	ülke
ülkenin	ülke
ülkeniz	ülke
ülkenizde	ülke
ülkenize	ülke
ülker	ülker
ülkesel	ülke
ülkesi	ülke
ülkesidir	ülke
ülkesinde	ülke
ülkesindeki	ülke
ülkesinden	ülke
ülkesine	ülke
ülkesini	ülke
ülkesinin	ülke
ülkeydi	ülke
ülkeye	ülke
ülkeyi	ülke
ülkeyiz	ülke
ülkeyle	ülke
ülser	ülser
ülsere	ülser
ülseri	ülser
ülserin	ülser
ülserler	ülser
ülserleri	ülser
ülserlerin	ülser
ülsever	ülsever
ültimatom	ültimatom
ümidi	ümid
ümidim	ümid
ümidimiz	ümid
ümidin	ümid
ümidini	ümid
ümidiyle	ümid
ümit	ümit
ümitköy	ümitköy
ümitle	ümit
ümitler	ümit
ümitleri	ümit
ümitlerini	ümit
ümitli	ümit
ümitliyim	ümit
ümitsiz	ümit
ümitsizliğe	ümit
ümitsizlik	ümit
ümitvar	ümitvar
ümmet	ümmet
ümmeti	ümmet
ümmetin	ümmet
ümmi	ümmi
ümran	ümran
ümraniye	ümraniye
ümraniye'de	ümraniye
ün	ün
ünü	ün
ünün	ün
ününü	ün
ününe	ün
ünüvar	ünüvar
ünal	ünal
ünal'ın	ünal
ünalan	ünalan
ünaydın	ünaydın
üncü	ün
ünde	ün
ünden	ün
üne	ün
üner	üner
üni	üni
üniforma	üniforma
üniformalı	üniforma
üniforması	üniforma
ünite	ünite
ünitede	ünite
ünitedeki	ünite
üniteden	ünite
ünitedir	ünite
üniteler	ünite
ünitelerde	ünite
ünitelerden	ünite
ünitelerdir	ünite
ünitelere	ünite
üniteleri	ünite
üniteleridir	ünite
ünitelerin	ünite
ünitelerince	ünite
ünitelerinde	ünite
ünitelerinden	ünite
ünitelerine	ünite
ünitelerini	ünite
ünitelerinin	ünite
üniteleriyle	ünite
ünitelerle	ünite
ünitemiz	ünite
ünitemizde	ünite
ünitenin	ünite
üniter	üniter
ünitesi	ünite
ünitesi'ne	ünitesi
ünitesidir	ünite
ünitesinde	ünite
ünitesindeki	ünite
ünitesinden	ünite
ünitesine	ünite
ünitesini	ünite
ünitesinin	ünite
ünitesiyle	ünite
üniteye	ünite
üniteyi	ünite
üniv	üniv
üniversal	üniversal
üniversite	üniversite
üniversite'de	üniversite
üniversite'deki	üniversite
üniversite'den	üniversite
üniversite'nin	üniversite
üniversite'ye	üniversite
üniversitece	üniversite
üniversitede	üniversite
üniversitedeki	üniversite
üniversiteden	üniversite
üniversitedir	üniversite
üniversiteler	üniversite
üniversitelerce	üniversite
üniversitelerde	üniversite
üniversitelerdeki	üniversite
üniversitelerden	üniversite
üniversitelere	üniversite
üniversiteleri	üniversite
üniversitelerimiz	üniversite
üniversitelerimizde	üniversite
üniversitelerimizdeki	üniversite
üniversitelerimize	üniversite
üniversitelerimizin	üniversite
üniversitelerin	üniversite
üniversitelerince	üniversite
üniversitelerinde	üniversite
üniversitelerindeki	üniversite
üniversitelerinden	üniversite
üniversitelerine	üniversite
üniversitelerinin	üniversite
üniversitelerle	üniversite
üniversiteli	üniversite
üniversiteliler	üniversite
üniversitemiz	üniversite
üniversitemizce	üniversite
üniversitemizde	üniversite
üniversitemizdeki	üniversite
üniversitemizden	üniversite
üniversitemize	üniversite
üniversitemizi	üniversite
üniversitemizin	üniversite
üniversitenin	üniversite
üniversiteniz	üniversite
üniversitenizde	üniversite
üniversitenize	üniversite
üniversitenizin	üniversite
üniversitesi	üniversite
üniversitesi'nde	üniversitesi
üniversitesi'ndeki	üniversitesi
üniversitesi'nden	üniversitesi
üniversitesi'ne	üniversitesi
üniversitesi'ni	üniversitesi
üniversitesi'nin	üniversitesi
üniversitesidir	üniversite
üniversitesinde	üniversite
üniversitesindeki	üniversite
üniversitesinden	üniversite
üniversitesine	üniversite
üniversitesini	üniversite
üniversitesinin	üniversite
üniversiteye	üniversite
üniversiteyi	üniversite
ünlü	ünlü
ünlüdür	ünlü
ünlülü	ünlü
ünlüler	ünlü
ünlüleri	ünlü
ünlülerin	ünlü
ünlülerle	ünlü
ünlünün	ünlü
ünlüsü	ünlü
ünlüydü	ünlü
ünlüyle	ünlü
ünlem	ünlem
ünlenen	ünlen
ünlenmiş	ünlen
ünsüz	ünsüz
ünsüzü	ünsüz
ünsüzler	ünsüz
ünsüzleri	ünsüz
ünsal	ünsal
ünv	ünv
ünvan	ünvan
ünvanı	ünvan
ünvanın	ünvan
ünvanını	ünvan
ünvanının	ünvan
ünvanına	ünvan
ünvanıyla	ünvan
ünvana	ünvan
ünvanlı	ünvan
ünvanlar	ünvan
ünvanları	ünvan
ünvanlarını	ünvan
ünvanlara	ünvan
ünvanlarla	ünvan
ünver	ünver
ünye	ünye
ürün	ürün
ürünü	ürün
ürünüdür	ürün
ürünümüz	ürün
ürünümüzü	ürün
ürünümüzün	ürün
ürünümüzdür	ürün
ürünün	ürün
ürününü	ürün
ürününün	ürün
ürününüz	ürün
ürününüzü	ürün
ürününüzün	ürün
ürününde	ürün
ürününden	ürün
ürününe	ürün
ürünüydü	ürün
ürünüyle	ürün
üründür	ürün
üründe	ürün
üründen	ürün
ürüne	ürün
ürünle	ürün
ürünler	ürün
ürünlerde	ürün
ürünlerdeki	ürün
ürünlerden	ürün
ürünlerdir	ürün
ürünlere	ürün
ürünleri	ürün
ürünleridir	ürün
ürünlerimiz	ürün
ürünlerimizde	ürün
ürünlerimizden	ürün
ürünlerimize	ürün
ürünlerimizi	ürün
ürünlerimizin	ürün
ürünlerimizle	ürün
ürünlerin	ürün
ürünlerinde	ürün
ürünlerindeki	ürün
ürünlerinden	ürün
ürünlerine	ürün
ürünlerini	ürün
ürünlerinin	ürün
ürünleriniz	ürün
ürünlerinize	ürün
ürünlerinizi	ürün
ürünlerinizin	ürün
ürünleriydi	ürün
ürünleriyle	ürün
ürünlerle	ürün
ürdün	ürdün
ürdün'ün	ürdün
ürdün'de	ürdün
ürdün'den	ürdün
ürdün'e	ürdün
üre	üre
ürediği	üre
ürediği	üre
üreme	üre
üremek	üre
üremektedir	üre
üremeleri	üre
üremelerini	üre
üremenin	üre
üremesi	üre
üremesine	üre
üremesini	üre
üremeye	üre
üremi	üre
üremik	üremik
ürer	üre
ürerler	üre
üret	üret
üretebileceği	üret
üretebilecek	üret
üretebilen	üret
üretebilir	üret
üretebiliriz	üret
üretebilirler	üret
üretebilirsiniz	üret
üretebiliyor	üret
üretebiliyoruz	üret
üretebilme	üret
üretebilmek	üret
üretebilmektedir	üret
üretebilmesi	üret
üreteceği	üret
üreteceğini	üret
üreteceğiz	üret
üretecek	üret
üretecekleri	üret
üretecektir	üret
üreteci	üretec
üretelim	üret
üretemeyen	üret
üretemez	üret
üretemiyoruz	üret
üreten	üret
üretenler	üret
üretenlere	üret
üretenleri	üret
üretenlerin	üret
üreter	üre
üreterek	üret
üreterler	üre
üretici	üret
üreticiden	üret
üreticiler	üret
üreticilerce	üret
üreticilerden	üret
üreticilere	üret
üreticileri	üret
üreticilerimiz	üret
üreticilerimizin	üret
üreticilerin	üret
üreticilerinden	üret
üreticilerindendir	üret
üreticilerine	üret
üreticilerini	üret
üreticilerinin	üret
üreticinin	üret
üreticisi	üret
üreticisidir	üret
üreticisinden	üret
üreticisine	üret
üreticisini	üret
üreticisinin	üret
üreticiye	üret
üreticiyi	üret
üretildi	üret
üretildiği	üret
üretildiğine	üret
üretildiğini	üret
üretildiği	üret
üretildikleri	üret
üretildikten	üret
üretilebildiği	üret
üretilebilecek	üret
üretilebilen	üret
üretilebilir	üret
üretilebilmektedir	üret
üretilebilmesi	üret
üretileceği	üret
üretilecek	üret
üretilecektir	üret
üretilemeyen	üret
üretilemez	üret
üretilen	üret
üretilerek	üret
üretilip	üret
üretilir	üret
üretilirken	üret
üretilirler	üret
üretiliyor	üret
üretiliyordu	üret
üretilmek	üret
üretilmekte	üret
üretilmektedir	üret
üretilmektedirler	üret
üretilmelidir	üret
üretilmemektedir	üret
üretilmesi	üret
üretilmesidir	üret
üretilmesinde	üret
üretilmesinden	üret
üretilmesine	üret
üretilmesini	üret
üretilmesinin	üret
üretilmeye	üret
üretilmeyen	üret
üretilmez	üret
üretilmiş	üret
üretilmişlerdir	üret
üretilmiştir	üret
üretim	üretim
üretimde	üretim
üretimdeki	üretim
üretimden	üretim
üretime	üretim
üretimi	üretim
üretimidir	üretim
üretimimiz	üretim
üretimimizi	üretim
üretimimizin	üretim
üretimin	üretim
üretiminde	üretim
üretimindeki	üretim
üretiminden	üretim
üretimine	üretim
üretimini	üretim
üretiminin	üretim
üretimiyle	üretim
üretimle	üretim
üretimler	üretim
üretimlerde	üretim
üretimleri	üretim
üretimlerin	üretim
üretimlerinde	üretim
üretimlerine	üretim
üretimlerini	üretim
üretimlerinin	üretim
üretin	üret
üretip	üret
üretir	üret
üretiriz	üret
üretirken	üret
üretirler	üret
üretiyor	üret
üretiyordu	üret
üretiyorlar	üret
üretiyoruz	üret
üretken	üretken
üretkendir	üretken
üretkenliğe	üretken
üretkenliği	üretken
üretkenliğin	üretken
üretkenliğini	üretken
üretkenliğinizi	üretken
üretkenlik	üretken
üretkenliklerini	üretken
üretme	üret
üretmede	üret
üretmeden	üret
üretmek	üret
üretmekle	üret
üretmekte	üret
üretmektedir	üret
üretmektedirler	üret
üretmekten	üret
üretmekteyiz	üret
üretmektir	üret
üretmeleri	üret
üretmeli	üret
üretmelidir	üret
üretmeliyiz	üret
üretmemiz	üret
üretmenin	üret
üretmesi	üret
üretmesidir	üret
üretmesine	üret
üretmesini	üret
üretmeye	üret
üretmeyen	üret
üretmeyi	üret
üretmiş	üret
üretmişlerdir	üret
üretmiştir	üret
üretmiyor	üret
üretmiyoruz	üret
üretra	üretra
üretranın	üretra
üretti	üret
ürettiği	üret
ürettiğimiz	üret
ürettiğinden	üret
ürettiğini	üret
ürettiğiniz	üret
ürettiği	üret
ürettik	üret
ürettikleri	üret
ürettiklerini	üret
ürettiler	üret
üreyen	üre
üreyip	üre
ürkütücü	ürküt
ürkütücüdür	ürküt
ürküten	ürküt
ürkek	ürkek
ürkmüş	ürk
ürktü	ürk
üroloji	üroloji
ürolojik	ürolojik
ürolojisi	üroloji
ürperdi	ürper
ürperten	ürper
ürperti	ürperti
ürpertici	ürper
ürtiker	ürtiker
üs	üs
üsküdar	üsküdar
üsküdar'a	üsküdar
üsküdar'da	üsküdar
üsküdar'dan	üsküdar
üsküp	üsküp
üslü	üs
üsler	üs
üsleri	üs
üslerin	üs
üslerinden	üs
üslerinin	üs
üsluba	üslub
üslubu	üslub
üslubun	üslub
üslubunda	üslub
üslubunu	üslub
üslubunun	üslub
üslubuyla	üslub
üslup	üslup
üslupla	üslup
üsluplar	üslup
üslupta	üslup
üssü	üss
üssün	üss
üssünden	üss
üssüne	üss
üssel	üs
üst	üst
üstü	üst
üstümüze	üst
üstümde	üst
üstüme	üst
üstün	üstün
üstünü	üst
üstünün	üst
üstünüzü	üst
üstünüze	üst
üstündür	üstün
üstündağ	üstündağ
üstünde	üst
üstündedir	üst
üstündeki	üst
üstünden	üst
üstüne	üstüne
üstüner	üstüner
üstünkörü	üstünkörü
üstünlüğü	üstün
üstünlüğün	üstün
üstünlüğünü	üstün
üstünlüğünün	üstün
üstünlüğünden	üstün
üstünlüğüne	üstün
üstünlüğe	üstün
üstünlüğü	üstün
üstünlüğünü	üstün
üstünlük	üst
üstünlükler	üstün
üstünlüklere	üstün
üstünlükleri	üstün
üstünlüklerinden	üstün
üstünlüklerinin	üstün
üstüste	üstüste
üstadı	üstad
üstadım	üstad
üstat	üstat
üste	üs
üsteğmen	üsteğmen
üstel	üstel
üstelik	üstelik
üstelikte	üstelik
üstesinden	üste
üstlük	üst
üstlendi	üstlen
üstlendiği	üstlen
üstlendiğimiz	üstlen
üstlendiğini	üstlen
üstlendiği	üstlen
üstlendik	üstlen
üstlendikleri	üstlen
üstlendiler	üstlen
üstlenebilir	üstlen
üstlenebilirler	üstlen
üstleneceği	üstlen
üstlenecek	üstlen
üstlenecektir	üstlen
üstlenemez	üstlen
üstlenen	üstlen
üstlenerek	üstlen
üstlenildiği	üstlen
üstlenilen	üstlen
üstlenilmektedir	üstlen
üstlenilmesi	üstlen
üstlenilmiştir	üstlen
üstlenip	üstlen
üstlenir	üstlen
üstlenirken	üstlen
üstlenirler	üstlen
üstleniyor	üstlen
üstleniyoruz	üstlen
üstlenme	üstlen
üstlenmek	üstlen
üstlenmektedir	üstlen
üstlenmeleri	üstlen
üstlenmelidir	üstlen
üstlenmesi	üstlen
üstlenmesini	üstlen
üstlenmeye	üstlen
üstlenmeyi	üstlen
üstlenmiş	üstlen
üstlenmişlerdir	üstlen
üstlenmişti	üstlen
üstlenmiştir	üstlen
üstleri	üst
üstlerinde	üst
üstlerine	üst
üstlerini	üst
üstlerinin	üst
üstte	üst
üstteki	üst
üstten	üstten
üstyapı	üstyapı
ütü	ütü
ütüleme	ütüle
ütüler	ütü
ütopik	ütopik
ütopya	ütopya
ütopyalar	ütopya
üvey	üvey
üye	üye
üyeden	üye
üyedir	üye
üyeler	üye
üyelerce	üye
üyelerde	üye
üyelerden	üye
üyelerdir	üye
üyelere	üye
üyeleri	üye
üyeleridir	üye
üyelerimiz	üye
üyelerimizde	üye
üyelerimizden	üye
üyelerimize	üye
üyelerimizi	üye
üyelerimizin	üye
üyelerimizle	üye
üyelerin	üye
üyelerince	üye
üyelerinde	üye
üyelerinden	üye
üyelerine	üye
üyelerini	üye
üyelerinin	üye
üyeleriniz	üye
üyelerinize	üye
üyeleriyle	üye
üyelerle	üye
üyeli	üye
üyeliğe	üye
üyeliği	üye
üyeliği'ne	üyeliği
üyeliğimiz	üye
üyeliğin	üye
üyeliğinde	üye
üyeliğinden	üye
üyeliğine	üye
üyeliğini	üye
üyeliğinin	üye
üyeliğinizi	üye
üyeliğiyle	üye
üyeliğe	üye
üyeliği	üye
üyeliğine	üye
üyelik	üye
üyelikle	üye
üyelikler	üye
üyeliklerde	üye
üyeliklere	üye
üyelikleri	üye
üyeliklerin	üye
üyeliklerinde	üye
üyeliklerinden	üye
üyeliklerine	üye
üyeliklerini	üye
üyeliklerinin	üye
üyelikte	üye
üyelikten	üye
üyemiz	üye
üyemize	üye
üyemizi	üye
üyemizin	üye
üyemizle	üye
üyenin	üye
üyesi	üye
üyesidir	üye
üyesidirler	üye
üyesince	üye
üyesinden	üye
üyesine	üye
üyesini	üye
üyesinin	üye
üyesiydi	üye
üyesiyim	üye
üyesiyle	üye
üyesiyseniz	üye
üyeye	üye
üyeyi	üye
üyeyle	üye
üz	üz
üzücü	üz
üzücüdür	üz
üzülüp	üzül
üzülür	üzül
üzülürüm	üzül
üzülürüz	üzül
üzülüyor	üzül
üzülüyorum	üzül
üzülüyoruz	üzül
üzüldü	üzül
üzüldüğüm	üzül
üzüldüğünü	üzül
üzüldük	üzül
üzüldüm	üzül
üzülecek	üzül
üzülen	üzül
üzülerek	üzül
üzülmüş	üzül
üzülmüştü	üzül
üzülme	üzül
üzülmeyin	üzül
üzülmez	üzül
üzüm	üzü
üzümü	üzü
üzümün	üzü
üzümdür	üzü
üzümde	üzü
üzümlü	üzümlü
üzümler	üzüm
üzümlerden	üzüm
üzümleri	üzüm
üzümlerin	üzüm
üzüntü	üzüntü
üzüntüden	üzüntü
üzüntülü	üzüntü
üzüntüleri	üzüntü
üzüntülerimizi	üzüntü
üzüntülerini	üzüntü
üzüntüm	üzüntü
üzüntümüz	üzüntü
üzüntünün	üzüntü
üzüntüsü	üzüntü
üzüntüsünü	üzüntü
üzüntüsünden	üzüntü
üzüntüyü	üzüntü
üzüntüye	üzüntü
üzüntüyle	üzüntü
üzüyor	üz
üzdü	üz
üze	üz
üzecek	üz
üzen	üz
üzer	üz
üzere	üzere
üzeredir	üzer
üzereydi	üzer
üzereyim	üzer
üzereyiz	üzer
üzereyken	üzer
üzeri	üzer
üzeride	üzeri
üzerimde	üzer
üzerimdeki	üzer
üzerimden	üzer
üzerime	üzer
üzerimizde	üzer
üzerimizdeki	üzer
üzerimizden	üzer
üzerimize	üzer
üzerin	üzer
üzerinde	üzerinde
üzerindedir	üzer
üzerindeki	üzer
üzerinden	üzer
üzerindeydi	üzer
üzerindeyken	üzer
üzerine	üzerine
üzerinedir	üzer
üzerineydi	üzer
üzerini	üzer
üzerinin	üzer
üzerinizde	üzer
üzerinizden	üzer
üzerinize	üzer
üzerleri	üzer
üzerlerinde	üzer
üzerlerindeki	üzer
üzerlerinden	üzer
üzerlerine	üzer
üzerlik	üzerlik
üzeyir	üzeyir
üzeyir'in	üzeyir
üzmüştü	üz
üzmüştür	üz
üzmek	üz
üzmektedir	üz
üzre	üzre
a	a
a'da	a
a'dan	a
a'nın	a
a'ya	a
aç	aç
açı	aç
açığı	açığ
açığım	açığ
açığın	açığ
açığını	açığ
açığının	açığ
açığında	açığ
açığız	açığ
açığa	açığ
açış	aç
açıcı	aç
açıcıdır	aç
açıdır	aç
açıda	açı
açıdan	açı
açık	açık
açıkça	açık
açıkçası	açıkçası
açıköğretim	açıköğretim
açıköğretime	açıköğretim
açıköğretimin	açıköğretim
açıkalın	açıkalın
açıkdeniz	açıkdeniz
açıkhava	açıkhava
açıkken	açık
açıklığı	açık
açıklığın	açık
açıklığını	açık
açıklığının	açık
açıklığında	açık
açıklığıyla	açık
açıklığa	açık
açıklık	açık
açıklıklı	açık
açıklıkla	açık
açıklıklar	açık
açıklıkları	açık
açıklıklardan	açık
açıklıkta	açık
açıklıktan	açık
açıklıyor	açıkl
açıklıyordu	açıkl
açıklıyorlar	açıkl
açıklıyoruz	açıkl
açıkladı	açıkla
açıkladığı	açıkla
açıkladığım	açıkla
açıkladığımız	açıkla
açıkladığını	açıkla
açıkladık	açıkla
açıkladıktan	açıkla
açıkladılar	açıkla
açıkladım	açıkla
açıklamış	açıkla
açıklamıştı	açıkla
açıklamıştır	açıkla
açıklama	açıkla
açıklamadı	açıkla
açıklamadır	açıklama
açıklamada	açıklama
açıklamadan	açıkla
açıklamak	açıkla
açıklamakta	açıkla
açıklamaktadır	açıkla
açıklamaktan	açıkla
açıklamalı	açıkla
açıklamalıdır	açıkla
açıklamalıdırlar	açıkla
açıklamalar	açıklama
açıklamaları	açıklama
açıklamaların	açıklama
açıklamalarını	açıklama
açıklamalarının	açıklama
açıklamalarına	açıklama
açıklamalarında	açıklama
açıklamalarından	açıklama
açıklamalarıyla	açıklama
açıklamalara	açıklama
açıklamalarda	açıklama
açıklamalardan	açıklama
açıklamalarla	açıklama
açıklamanın	açıklama
açıklamanızı	açıklama
açıklaması	açıklama
açıklamasını	açıklama
açıklamasının	açıklama
açıklamasına	açıklama
açıklamasında	açıklama
açıklamasından	açıklama
açıklamasıyla	açıklama
açıklamayı	açıklama
açıklamaya	açıkla
açıklamayla	açıklama
açıklanıp	açık
açıklanır	açık
açıklanıyor	açık
açıklanabilir	açık
açıklanabilmektedir	açık
açıklanacağı	açık
açıklanacak	açık
açıklanacaktır	açık
açıklanamayan	açık
açıklanamaz	açık
açıklanan	açık
açıklanarak	açık
açıklandı	açık
açıklandığı	açık
açıklandığında	açık
açıklandıktan	açık
açıklanmış	açık
açıklanmıştı	açık
açıklanmıştır	açık
açıklanmadı	açık
açıklanmak	açık
açıklanmakta	açık
açıklanmaktadır	açık
açıklanmalı	açık
açıklanmalıdır	açık
açıklanmamış	açık
açıklanmaması	açık
açıklanması	açık
açıklanmasını	açık
açıklanmasının	açık
açıklanmasına	açık
açıklanmasında	açık
açıklanmasından	açık
açıklanmaya	açık
açıklanmayan	açık
açıklanmaz	açık
açıklar	açık
açıkları	açık
açıkların	açık
açıklarını	açık
açıklarının	açık
açıklarına	açık
açıklarında	açık
açıklarındaki	açık
açıklarından	açık
açıklarken	açıkla
açıklarlar	açıkla
açıklasın	açıkla
açıklayıcı	açıkla
açıklayın	açıkla
açıklayınız	açıkla
açıklayabilir	açıkla
açıklayabiliriz	açıkla
açıklayabilmek	açıkla
açıklayacağım	açıkla
açıklayacak	açıkla
açıklayalım	açıkla
açıklayamaz	açıkla
açıklayan	açıkla
açıklayarak	açıkla
açıklayayım	açıkla
açıkoturum	açıkoturum
açıksa	açık
açıktı	açık
açıktır	açık
açıktırlar	açık
açıkta	açık
açıktaki	açık
açıktan	açıktan
açılı	açı
açılış	aç
açılışı	aç
açılışın	aç
açılışını	aç
açılışının	aç
açılışına	aç
açılışında	aç
açılışından	aç
açılışa	aç
açılışlar	aç
açılışlarda	aç
açılışta	aç
açılıştan	aç
açılım	açılım
açılımı	açılım
açılımını	açılım
açılımlar	açılım
açılımları	açılım
açılınca	aç
açılıncaya	aç
açılıp	aç
açılır	aç
açılırdı	aç
açılırken	aç
açılırlar	aç
açılırsa	aç
açılıyor	açıl
açılıyordu	açıl
açılabileceği	aç
açılabilecek	aç
açılabilen	aç
açılabilir	aç
açılabiliyor	aç
açılabilmektedir	aç
açılabilmesi	aç
açılacağı	aç
açılacağını	aç
açılacağına	aç
açılacak	aç
açılacaktı	aç
açılacaktır	aç
açılamadığı	açıla
açılamaz	açıla
açılan	aç
açılana	açıla
açılar	açı
açıları	açı
açıların	açı
açılarını	açı
açılarının	açı
açılarına	açı
açılarından	açı
açılarıyla	açı
açılarak	aç
açılarda	açı
açılardan	açı
açılarla	açı
açıldı	aç
açıldığı	aç
açıldığını	aç
açıldığında	aç
açıldığından	aç
açıldıktan	aç
açılmış	aç
açılmışken	aç
açılmışsa	aç
açılmıştı	aç
açılmıştır	aç
açılmıyor	aç
açılma	aç
açılmadı	aç
açılmadığı	aç
açılmadan	aç
açılmak	aç
açılmaksızın	aç
açılmakta	aç
açılmaktadır	aç
açılmalı	aç
açılmalıdır	aç
açılmamış	aç
açılmamıştır	aç
açılmamalıdır	aç
açılmaması	aç
açılmamasına	aç
açılmanın	aç
açılması	aç
açılmasıdır	aç
açılmasını	aç
açılmasının	aç
açılmasına	aç
açılmasında	aç
açılmasından	aç
açılmasıyla	aç
açılmayı	aç
açılmaya	aç
açılmayacağı	aç
açılmayacak	aç
açılmayacaktır	aç
açılmayan	aç
açılmaz	aç
açılmazsa	aç
açılsın	aç
açım	aç
açımı	aç
açımız	aç
açımızdan	aç
açımda	aç
açımdan	aç
açın	aç
açının	aç
açınız	aç
açınızdan	aç
açınca	aç
açıp	aç
açısı	açı
açısını	açı
açısının	açı
açısına	açı
açısında	açı
açısından	açı
açısıyla	açı
açısal	açı
açıyı	açı
açıya	açı
açıyla	aç
açıyor	aç
açıyordu	aç
açıyorlar	aç
açıyorsa	aç
açıyorsunuz	aç
açıyorum	aç
açıyoruz	aç
açabildiği	aç
açabileceği	aç
açabileceğini	aç
açabilecek	aç
açabilecektir	aç
açabilen	aç
açabilir	aç
açabilirdi	aç
açabiliriz	aç
açabilirler	aç
açabilirsiniz	aç
açabiliyor	aç
açabilmek	aç
açabilmektedir	aç
açabilmesi	aç
açacağı	açacağ
açacağımız	açacağ
açacağını	açacağ
açacağınız	açacağ
açacağına	açacağ
açacağız	aç
açacak	aç
açacaklar	aç
açacakları	açacak
açacaktır	aç
açalım	aç
açamaz	aç
açamazlar	aç
açan	aç
açanlar	açan
açanların	açan
açar	aç
açarım	aç
açarak	aç
açardı	aç
açarken	aç
açarlar	aç
açarsınız	aç
açarsa	aç
açarsak	aç
açba	açba
açelya	açelya
açken	aç
açlığı	açlığ
açlığın	açlığ
açlığını	açlığ
açlığa	açlığ
açlık	açlık
açlıkla	açlık
açlıktan	açlık
açmış	aç
açmışlar	aç
açmışlardı	aç
açmışlardır	aç
açmıştı	aç
açmıştır	aç
açmıyor	aç
açma	aç
açmadı	aç
açmadığı	aç
açmadan	aç
açmak	aç
açmakla	aç
açmaktır	aç
açmakta	aç
açmaktadır	aç
açmaktadırlar	aç
açmaktan	aç
açmalı	aç
açmaları	açma
açmalarını	açma
açmamız	açma
açmama	açma
açmamak	aç
açmaması	aç
açmanın	açma
açmanız	açma
açması	açma
açmasını	açma
açmasının	açma
açmasına	açma
açmasından	açma
açmayı	açma
açmayın	aç
açmaya	aç
açmayacak	aç
açmayan	aç
açmaz	aç
açmazı	açmaz
açmazlar	aç
açsın	aç
açtı	aç
açtığı	aç
açtığım	aç
açtığımız	aç
açtığımızda	aç
açtığımda	aç
açtığını	aç
açtığınız	aç
açtığınızda	aç
açtığına	aç
açtığında	aç
açtığından	aç
açtık	aç
açtıkları	aç
açtıklarını	aç
açtıktan	aç
açtılar	aç
açtım	aç
açtınız	aç
açtır	aç
açtırılan	aç
açtırabilirsiniz	aç
açtırdığı	aç
açtırmıyor	aç
açtırma	aç
açtırmak	aç
açtırmanız	aç
ağ	ağ
ağ'ın	ağ
ağı	ağ
ağıdır	ağ
ağıl	ağıl
ağımız	ağ
ağımızı	ağ
ağın	ağ
ağını	ağ
ağının	ağ
ağınız	ağ
ağınızı	ağ
ağınızın	ağ
ağınıza	ağ
ağınızda	ağ
ağınızdaki	ağ
ağına	ağ
ağında	ağ
ağındaki	ağ
ağından	ağ
ağır	ağır
ağırbaşlı	ağırbaşlı
ağırdı	ağır
ağırdır	ağır
ağırdan	ağır
ağırlığı	ağırlığ
ağırlığıdır	ağırlığ
ağırlığım	ağırlığ
ağırlığın	ağırlığ
ağırlığını	ağırlığ
ağırlığının	ağırlığ
ağırlığınız	ağırlığ
ağırlığına	ağırlığ
ağırlığında	ağırlığ
ağırlığındadır	ağırlığ
ağırlığındaki	ağırlığ
ağırlığından	ağırlığ
ağırlığıyla	ağırlığ
ağırlığa	ağırlığ
ağırlık	ağırlık
ağırlıklı	ağırlık
ağırlıklıdır	ağırlık
ağırlıkla	ağırlık
ağırlıklar	ağırlık
ağırlıkları	ağırlık
ağırlıklarını	ağırlık
ağırlıklarının	ağırlık
ağırlıklarına	ağırlık
ağırlıklara	ağırlık
ağırlıkta	ağırlık
ağırlıktadır	ağırlık
ağırlıktaki	ağırlık
ağırlıyor	ağırl
ağırlaşıyor	ağır
ağırlaşan	ağır
ağırlaşmış	ağır
ağırlaşması	ağır
ağırlaştı	ağır
ağırlaştığı	ağır
